Stage,Timestamp,File Name,Prompt Tokens,Completion Tokens,Total Tokens,Cached Tokens
labeling,2025-02-28T10:40:09.110566,0279901b645e568591ad95dac2c2bf939ef0c00d,100265,462,100727,0
labeling,2025-02-28T10:40:18.683874,0279901b645e568591ad95dac2c2bf939ef0c00d,38625,544,39169,0
labeling,2025-02-28T10:40:49.558088,0981826b4b43a88920f3e01c71ae73539bab84cc,90524,240,90764,0
labeling,2025-02-28T10:41:39.964836,0a61a353b1ea9fd9b8f63b60239634ca3007d58f,99523,356,99879,0
labeling,2025-02-28T10:41:42.704948,0a61a353b1ea9fd9b8f63b60239634ca3007d58f,7770,135,7905,0
labeling,2025-02-28T10:42:00.967048,0c0faea14d108e1617f2d6d2a7c1aae04eb88fe0,41505,127,41632,0
labeling,2025-02-28T10:42:28.299827,0f111d244aee3d976684995a222fa177a64571c4,75721,321,76042,0
labeling,2025-02-28T10:42:39.047419,105688726e097505beef4934896193ac51295037,27763,381,28144,0
labeling,2025-02-28T10:43:05.141286,12bff07b957b1c8f8cad9d917ca18005720cce9b,44877,653,45530,0
labeling,2025-02-28T10:43:32.623169,13999998018cc53440310d94a26d1e8957e2277f,82550,235,82785,0
labeling,2025-02-28T10:44:36.928260,14fa568899745270c4ff2c10073f97f2c2e7764b,97368,568,97936,0
labeling,2025-02-28T10:44:39.177830,14fa568899745270c4ff2c10073f97f2c2e7764b,4915,76,4991,0
labeling,2025-02-28T10:45:31.949481,1a12ef3f11a64e92eeca39e493a17d2860c014a6,96957,245,97202,0
labeling,2025-02-28T10:46:44.239444,1ab89c81bdb49d4bfba2202eeb8e1c93bed414c7,100472,447,100919,0
labeling,2025-02-28T10:46:59.333443,1ab89c81bdb49d4bfba2202eeb8e1c93bed414c7,99478,464,99942,0
labeling,2025-02-28T10:47:05.247123,1ab89c81bdb49d4bfba2202eeb8e1c93bed414c7,8502,569,9071,0
labeling,2025-02-28T10:47:25.172981,1af8f906e34af6e0acfe4f73e37093bbe34700f3,54103,375,54478,0
labeling,2025-02-28T10:47:42.450434,1bd670f9cdf088266db849722c3aded77a2f4894,56842,92,56934,0
labeling,2025-02-28T10:48:44.071615,23b2c590c4887dfb86761730dd7156fe3b216ab7,100326,558,100884,0
labeling,2025-02-28T10:48:45.912417,23b2c590c4887dfb86761730dd7156fe3b216ab7,12541,64,12605,0
labeling,2025-02-28T10:49:12.894866,2cdfd39bbf896b0f6651ebb0fe697cdf8c7ef0e8,91131,74,91205,0
labeling,2025-02-28T10:50:12.188389,2db41ba86cc015db1f5f7de00b764a06e6de3dcc,99594,543,100137,0
labeling,2025-02-28T10:50:19.130800,2db41ba86cc015db1f5f7de00b764a06e6de3dcc,74601,144,74745,0
labeling,2025-02-28T10:50:58.354561,2e315764be39701457b88c23f70c5ddede4b2453,97525,160,97685,0
labeling,2025-02-28T10:51:46.946182,2fd79ae4ebe4943384c119eb1d1e9286ba3c5074,80423,407,80830,0
labeling,2025-02-28T10:52:23.875151,30f64d1043f4cb425eb636763580ae27094ffef1,74597,316,74913,0
labeling,2025-02-28T10:52:38.642349,31a60b930e0f1034afff6e2d1e406e7d9141b2a1,34628,354,34982,0
labeling,2025-02-28T10:53:03.895646,31e16caf2a6d45fb9cc41fb158b49933df4895f7,37362,112,37474,0
labeling,2025-02-28T10:53:55.263727,35839effbc332f23d5f34263aab3dcb2c6976420,100370,576,100946,0
labeling,2025-02-28T10:54:01.019672,35839effbc332f23d5f34263aab3dcb2c6976420,49384,184,49568,0
labeling,2025-02-28T10:54:36.673936,36dd058d3237202cbb94139611c8b8a35ff8c158,100365,71,100436,0
labeling,2025-02-28T10:54:40.275822,36dd058d3237202cbb94139611c8b8a35ff8c158,52238,66,52304,0
labeling,2025-02-28T10:54:52.349069,3bb894b4201667baf60b0b2c8a47109fa2357acb,32228,281,32509,0
labeling,2025-02-28T10:55:04.589321,3e5ccdb58faf901e75e31f154cb8330869ca5efa,35582,249,35831,0
labeling,2025-02-28T10:56:06.430360,3f36d4f26ada778d89cf5a7344be0b9e9a5223a3,100462,495,100957,0
labeling,2025-02-28T10:56:17.899181,3f36d4f26ada778d89cf5a7344be0b9e9a5223a3,84360,404,84764,0
labeling,2025-02-28T10:57:00.777602,446545ae548543d8744f8d885ff75face3424ba4,100417,335,100752,0
labeling,2025-02-28T10:57:03.848077,446545ae548543d8744f8d885ff75face3424ba4,32303,101,32404,0
labeling,2025-02-28T10:57:35.959394,4d3e52b69b4b5366e54ce87cf641b01b1419bdee,100304,504,100808,0
labeling,2025-02-28T10:57:43.583931,4d3e52b69b4b5366e54ce87cf641b01b1419bdee,25131,533,25664,0
labeling,2025-02-28T10:57:57.289654,4e3efdc544140b872a59e124443a64c34f356911,6573,121,6694,0
labeling,2025-02-28T10:58:41.642093,51bae8eeb78cf7d8d96c5cb66c36c41c6bd71491,100393,352,100745,0
labeling,2025-02-28T10:58:48.355543,51bae8eeb78cf7d8d96c5cb66c36c41c6bd71491,85710,92,85802,0
labeling,2025-02-28T10:59:02.934489,53a00624418f6c5c2d044344a4125bba7743614f,2122,389,2511,0
labeling,2025-02-28T10:59:21.979736,53aa4bfb3b29d7fc064e97626fc4f860942ca9fd,28604,1088,29692,0
labeling,2025-02-28T10:59:48.134872,553afbf09b6d83166b17acb02431c6cf38e4defc,77301,157,77458,0
labeling,2025-02-28T11:00:37.355855,5a24fa827d172a7669eca206b2a5f47c2b19b48d,99797,308,100105,0
labeling,2025-02-28T11:00:46.865677,5a24fa827d172a7669eca206b2a5f47c2b19b48d,98628,200,98828,0
labeling,2025-02-28T11:03:06.104871,5bb5f71d1457f3272adab97d64a79c300da75cea,100510,618,101128,0
labeling,2025-02-28T11:03:24.680252,5bb5f71d1457f3272adab97d64a79c300da75cea,100142,575,100717,0
labeling,2025-02-28T11:03:36.174901,5bb5f71d1457f3272adab97d64a79c300da75cea,48453,572,49025,0
labeling,2025-02-28T11:04:09.458832,5f226fe96206888930e3baaf0bff70d4b0a1db40,100453,113,100566,0
labeling,2025-02-28T11:04:12.806946,5f226fe96206888930e3baaf0bff70d4b0a1db40,44054,94,44148,0
labeling,2025-02-28T11:05:00.981399,6159f86f38ec4f82453d99a01c22f1847de133c6,100189,100,100289,0
labeling,2025-02-28T11:05:10.654025,6159f86f38ec4f82453d99a01c22f1847de133c6,99923,184,100107,0
labeling,2025-02-28T11:05:12.859145,6159f86f38ec4f82453d99a01c22f1847de133c6,10358,135,10493,0
labeling,2025-02-28T11:05:31.043473,6406e378c1f49a29c836633f187c271b30b50183,48969,153,49122,0
labeling,2025-02-28T11:07:18.513580,6529fba868216a923407fb0d4e15a811a8e89ebc,99456,474,99930,0
labeling,2025-02-28T11:07:21.981854,6529fba868216a923407fb0d4e15a811a8e89ebc,9436,230,9666,0
labeling,2025-02-28T11:08:22.980432,67185fca2a09b3c46ee961b2c1ae160dab8b5231,99547,274,99821,0
labeling,2025-02-28T11:08:27.198509,67185fca2a09b3c46ee961b2c1ae160dab8b5231,38649,77,38726,0
labeling,2025-02-28T11:08:49.159182,674a255d82495ef40189645697460801193e5a2d,85756,142,85898,0
labeling,2025-02-28T11:09:40.585593,682de8e45fd9688f3452bc0e18257132a8f3cff6,99721,476,100197,0
labeling,2025-02-28T11:09:47.486565,682de8e45fd9688f3452bc0e18257132a8f3cff6,11967,404,12371,0
labeling,2025-02-28T11:12:08.314602,696ddc4c80febe0f1559ed3b1272487c74ca91cc,100066,492,100558,0
labeling,2025-02-28T11:12:13.302348,696ddc4c80febe0f1559ed3b1272487c74ca91cc,34114,253,34367,0
labeling,2025-02-28T11:12:58.372806,6d76ccb75bbf1b27ca60b8419c5343ac050cebb0,98505,311,98816,0
labeling,2025-02-28T11:13:09.509130,6d76ccb75bbf1b27ca60b8419c5343ac050cebb0,28685,462,29147,0
labeling,2025-02-28T11:13:37.019156,6e36d57320ec525da93b3ce2c7269580c746475b,100331,255,100586,0
labeling,2025-02-28T11:13:39.710480,6e36d57320ec525da93b3ce2c7269580c746475b,41544,67,41611,0
labeling,2025-02-28T11:13:54.576888,71d137454a1524843e1f49b34603438510232919,26328,57,26385,0
labeling,2025-02-28T11:14:39.897008,74c690176ce433301f4d1e808bb002a2f4dc321a,99765,437,100202,0
labeling,2025-02-28T11:14:46.516513,74c690176ce433301f4d1e808bb002a2f4dc321a,68698,158,68856,0
labeling,2025-02-28T11:29:41.003145,7792e23f8a40fb9461dbc26f417b0fb948f54f46,20155,73,20228,0
labeling,2025-02-28T11:29:43.667542,7792e23f8a40fb9461dbc26f417b0fb948f54f46,20278,69,20347,0
labeling,2025-02-28T11:29:45.643350,7792e23f8a40fb9461dbc26f417b0fb948f54f46,20307,48,20355,0
labeling,2025-02-28T11:29:47.173734,7792e23f8a40fb9461dbc26f417b0fb948f54f46,20256,26,20282,0
labeling,2025-02-28T11:29:49.093692,7792e23f8a40fb9461dbc26f417b0fb948f54f46,20040,28,20068,0
labeling,2025-02-28T11:29:50.706776,7792e23f8a40fb9461dbc26f417b0fb948f54f46,4849,59,4908,0
labeling,2025-02-28T11:30:35.025078,78c71282723c2d66216cbba13183d19349d302b8,20016,256,20272,0
labeling,2025-02-28T11:30:37.868361,78c71282723c2d66216cbba13183d19349d302b8,20421,121,20542,0
labeling,2025-02-28T11:30:46.119590,78c71282723c2d66216cbba13183d19349d302b8,20325,503,20828,0
labeling,2025-02-28T11:30:51.353986,78c71282723c2d66216cbba13183d19349d302b8,20491,306,20797,0
labeling,2025-02-28T11:30:54.090415,78c71282723c2d66216cbba13183d19349d302b8,20021,143,20164,0
labeling,2025-02-28T11:30:55.520416,78c71282723c2d66216cbba13183d19349d302b8,11629,29,11658,0
labeling,2025-02-28T11:31:23.431933,79ffb9b8682aa565172233c070a47d944464644c,20218,324,20542,0
labeling,2025-02-28T11:31:26.565621,79ffb9b8682aa565172233c070a47d944464644c,19822,140,19962,0
labeling,2025-02-28T11:31:30.227338,79ffb9b8682aa565172233c070a47d944464644c,20035,187,20222,0
labeling,2025-02-28T11:31:32.735620,79ffb9b8682aa565172233c070a47d944464644c,20006,142,20148,0
labeling,2025-02-28T11:31:34.752766,79ffb9b8682aa565172233c070a47d944464644c,20062,92,20154,0
labeling,2025-02-28T11:31:38.231424,79ffb9b8682aa565172233c070a47d944464644c,20055,239,20294,0
labeling,2025-02-28T11:31:41.181168,79ffb9b8682aa565172233c070a47d944464644c,20452,180,20632,0
labeling,2025-02-28T11:31:42.505360,79ffb9b8682aa565172233c070a47d944464644c,10157,37,10194,0
labeling,2025-02-28T11:32:02.112049,7be0f16625505fb48ad135c1a3fccd75ce06671c,19535,510,20045,0
labeling,2025-02-28T11:32:14.594257,7be0f16625505fb48ad135c1a3fccd75ce06671c,20151,350,20501,0
labeling,2025-02-28T11:33:13.178057,7be0f16625505fb48ad135c1a3fccd75ce06671c,20355,369,20724,0
labeling,2025-02-28T11:33:16.367168,7be0f16625505fb48ad135c1a3fccd75ce06671c,7897,137,8034,0
labeling,2025-02-28T11:34:18.587577,8467b7fce0d860b56e30c79d253d0bb5e9a32e95,20414,397,20811,0
labeling,2025-02-28T11:34:21.370870,8467b7fce0d860b56e30c79d253d0bb5e9a32e95,19746,165,19911,0
labeling,2025-02-28T11:34:30.366696,8467b7fce0d860b56e30c79d253d0bb5e9a32e95,19355,399,19754,0
labeling,2025-02-28T11:34:34.238350,8467b7fce0d860b56e30c79d253d0bb5e9a32e95,19830,238,20068,0
labeling,2025-02-28T11:34:38.446215,8467b7fce0d860b56e30c79d253d0bb5e9a32e95,18584,210,18794,0
labeling,2025-02-28T11:34:41.022532,8467b7fce0d860b56e30c79d253d0bb5e9a32e95,19428,130,19558,0
labeling,2025-02-28T11:34:43.804201,8467b7fce0d860b56e30c79d253d0bb5e9a32e95,19569,142,19711,0
labeling,2025-02-28T11:34:50.021845,8467b7fce0d860b56e30c79d253d0bb5e9a32e95,20360,412,20772,0
labeling,2025-02-28T11:34:56.060461,8467b7fce0d860b56e30c79d253d0bb5e9a32e95,4019,479,4498,0
labeling,2025-02-28T11:35:35.385590,8f5e29eea4f4a3e944707c71148439ca1fd4b2d8,20103,294,20397,0
labeling,2025-02-28T11:35:40.036543,8f5e29eea4f4a3e944707c71148439ca1fd4b2d8,20164,309,20473,0
labeling,2025-02-28T11:35:44.412656,8f5e29eea4f4a3e944707c71148439ca1fd4b2d8,20437,236,20673,0
labeling,2025-02-28T11:35:50.194654,8f5e29eea4f4a3e944707c71148439ca1fd4b2d8,14204,101,14305,0
labeling,2025-02-28T11:36:12.187982,91ba1d46cdde9c1c0cf34f6bcc107741244f8f3d,19948,248,20196,0
labeling,2025-02-28T11:36:15.731791,91ba1d46cdde9c1c0cf34f6bcc107741244f8f3d,19958,180,20138,0
labeling,2025-02-28T11:36:23.888466,91ba1d46cdde9c1c0cf34f6bcc107741244f8f3d,20180,535,20715,0
labeling,2025-02-28T11:36:27.055221,91ba1d46cdde9c1c0cf34f6bcc107741244f8f3d,20542,152,20694,0
labeling,2025-02-28T11:36:29.726452,91ba1d46cdde9c1c0cf34f6bcc107741244f8f3d,19416,125,19541,0
labeling,2025-02-28T11:36:51.369002,91caa5884d3fbc344a05ac2f1d113a5d8725e4cb,20085,409,20494,0
labeling,2025-02-28T11:36:56.456340,91caa5884d3fbc344a05ac2f1d113a5d8725e4cb,20271,266,20537,0
labeling,2025-02-28T11:36:58.901283,91caa5884d3fbc344a05ac2f1d113a5d8725e4cb,20118,115,20233,0
labeling,2025-02-28T11:37:02.346468,91caa5884d3fbc344a05ac2f1d113a5d8725e4cb,3089,232,3321,0
labeling,2025-02-28T11:37:21.601528,92d9de8e4db96e0b95a484afcd1c54c6beb62c03,20557,361,20918,0
labeling,2025-02-28T11:37:34.315831,92d9de8e4db96e0b95a484afcd1c54c6beb62c03,20170,133,20303,0
labeling,2025-02-28T11:37:39.917691,92d9de8e4db96e0b95a484afcd1c54c6beb62c03,14282,259,14541,0
labeling,2025-02-28T11:41:35.730088,957f31e694198a1695d14aa512a972ab6f3c55b5,20450,356,20806,0
labeling,2025-02-28T11:41:42.447606,957f31e694198a1695d14aa512a972ab6f3c55b5,20127,391,20518,0
labeling,2025-02-28T11:41:47.645007,957f31e694198a1695d14aa512a972ab6f3c55b5,19688,301,19989,0
labeling,2025-02-28T11:41:50.968850,957f31e694198a1695d14aa512a972ab6f3c55b5,19693,105,19798,0
labeling,2025-02-28T11:42:02.533904,957f31e694198a1695d14aa512a972ab6f3c55b5,19852,519,20371,0
labeling,2025-02-28T11:42:05.600549,957f31e694198a1695d14aa512a972ab6f3c55b5,19861,154,20015,0
labeling,2025-02-28T11:42:08.459682,957f31e694198a1695d14aa512a972ab6f3c55b5,19617,108,19725,0
labeling,2025-02-28T11:42:10.440429,957f31e694198a1695d14aa512a972ab6f3c55b5,5643,90,5733,0
labeling,2025-02-28T11:43:00.369298,980742aa08ea64d552c153bcefbd7e8243fb9efd,19407,384,19791,0
labeling,2025-02-28T11:43:02.934491,980742aa08ea64d552c153bcefbd7e8243fb9efd,20184,115,20299,0
labeling,2025-02-28T11:43:04.569465,980742aa08ea64d552c153bcefbd7e8243fb9efd,19548,66,19614,0
labeling,2025-02-28T11:43:12.085211,980742aa08ea64d552c153bcefbd7e8243fb9efd,20385,478,20863,0
labeling,2025-02-28T11:43:16.128737,980742aa08ea64d552c153bcefbd7e8243fb9efd,20078,245,20323,0
labeling,2025-02-28T11:43:27.103256,980742aa08ea64d552c153bcefbd7e8243fb9efd,20389,265,20654,0
labeling,2025-02-28T11:43:31.695772,980742aa08ea64d552c153bcefbd7e8243fb9efd,20142,169,20311,0
labeling,2025-02-28T11:43:32.523615,980742aa08ea64d552c153bcefbd7e8243fb9efd,2800,31,2831,0
labeling,2025-02-28T11:44:08.927960,99cd0edaf5bfb233e5f46ee55af837de0b725274,20152,80,20232,0
labeling,2025-02-28T11:44:14.615382,99cd0edaf5bfb233e5f46ee55af837de0b725274,20310,45,20355,0
labeling,2025-02-28T11:44:16.852458,99cd0edaf5bfb233e5f46ee55af837de0b725274,20067,50,20117,0
labeling,2025-02-28T11:44:20.126550,99cd0edaf5bfb233e5f46ee55af837de0b725274,11065,174,11239,0
labeling,2025-02-28T11:44:45.586765,9af0a7f8db3954c3e74851c8c1807a09ece8ef00,20073,126,20199,0
labeling,2025-02-28T11:44:48.958365,9af0a7f8db3954c3e74851c8c1807a09ece8ef00,19524,225,19749,0
labeling,2025-02-28T11:44:53.923052,9af0a7f8db3954c3e74851c8c1807a09ece8ef00,20296,261,20557,0
labeling,2025-02-28T11:45:04.700397,9af0a7f8db3954c3e74851c8c1807a09ece8ef00,20156,552,20708,0
labeling,2025-02-28T11:45:08.037681,9af0a7f8db3954c3e74851c8c1807a09ece8ef00,20533,123,20656,0
labeling,2025-02-28T11:45:15.970102,9af0a7f8db3954c3e74851c8c1807a09ece8ef00,20546,127,20673,0
labeling,2025-02-28T11:45:22.547283,9af0a7f8db3954c3e74851c8c1807a09ece8ef00,12191,491,12682,0
labeling,2025-02-28T11:46:32.069291,9b7fdb871fc4d4a8babc25448257ae0b81a6442d,19734,164,19898,0
labeling,2025-02-28T11:46:34.286404,9b7fdb871fc4d4a8babc25448257ae0b81a6442d,20290,36,20326,0
labeling,2025-02-28T11:46:36.277973,9b7fdb871fc4d4a8babc25448257ae0b81a6442d,20369,89,20458,0
labeling,2025-02-28T11:46:40.061496,9b7fdb871fc4d4a8babc25448257ae0b81a6442d,19569,134,19703,0
labeling,2025-02-28T11:46:42.858229,9b7fdb871fc4d4a8babc25448257ae0b81a6442d,19856,131,19987,0
labeling,2025-02-28T11:46:47.889348,9b7fdb871fc4d4a8babc25448257ae0b81a6442d,20381,263,20644,0
labeling,2025-02-28T11:46:50.123858,9b7fdb871fc4d4a8babc25448257ae0b81a6442d,19907,77,19984,0
labeling,2025-02-28T11:46:52.039722,9b7fdb871fc4d4a8babc25448257ae0b81a6442d,20047,67,20114,0
labeling,2025-02-28T11:46:56.048643,9b7fdb871fc4d4a8babc25448257ae0b81a6442d,15806,228,16034,0
labeling,2025-02-28T11:47:54.325033,9e794a58e511f6a6a9a13b201d652deff9f9f69a,20163,461,20624,0
labeling,2025-02-28T11:47:58.757441,9e794a58e511f6a6a9a13b201d652deff9f9f69a,20496,208,20704,0
labeling,2025-02-28T11:48:00.409815,9e794a58e511f6a6a9a13b201d652deff9f9f69a,19685,38,19723,0
labeling,2025-02-28T11:48:05.257009,9e794a58e511f6a6a9a13b201d652deff9f9f69a,20126,185,20311,0
labeling,2025-02-28T11:48:11.785697,9e794a58e511f6a6a9a13b201d652deff9f9f69a,20081,329,20410,0
labeling,2025-02-28T11:48:16.191480,9e794a58e511f6a6a9a13b201d652deff9f9f69a,20535,276,20811,0
labeling,2025-02-28T11:48:25.303193,9e794a58e511f6a6a9a13b201d652deff9f9f69a,20210,607,20817,0
labeling,2025-02-28T11:48:32.100322,9e794a58e511f6a6a9a13b201d652deff9f9f69a,20470,434,20904,0
labeling,2025-02-28T11:48:34.445185,9e794a58e511f6a6a9a13b201d652deff9f9f69a,19921,92,20013,0
labeling,2025-02-28T11:48:39.179611,9e794a58e511f6a6a9a13b201d652deff9f9f69a,20310,279,20589,0
labeling,2025-02-28T11:48:45.157532,9e794a58e511f6a6a9a13b201d652deff9f9f69a,20144,403,20547,0
labeling,2025-02-28T11:48:47.766957,9e794a58e511f6a6a9a13b201d652deff9f9f69a,9137,115,9252,0
labeling,2025-02-28T11:49:04.649654,a533b44fe091a8aa62d1fa4f0a3262b311df8bd9,20471,279,20750,0
labeling,2025-02-28T11:49:07.749740,a533b44fe091a8aa62d1fa4f0a3262b311df8bd9,20343,107,20450,0
labeling,2025-02-28T11:49:10.378732,a533b44fe091a8aa62d1fa4f0a3262b311df8bd9,20213,130,20343,0
labeling,2025-02-28T11:49:13.374384,a533b44fe091a8aa62d1fa4f0a3262b311df8bd9,19281,177,19458,0
labeling,2025-02-28T11:49:14.643687,a533b44fe091a8aa62d1fa4f0a3262b311df8bd9,12246,28,12274,0
labeling,2025-02-28T11:49:38.461221,a69ebee82a9acd54117407ca3697db0d7bfbfdac,20337,404,20741,0
labeling,2025-02-28T11:49:41.105969,a69ebee82a9acd54117407ca3697db0d7bfbfdac,19693,129,19822,0
labeling,2025-02-28T11:49:45.575888,a69ebee82a9acd54117407ca3697db0d7bfbfdac,20139,303,20442,0
labeling,2025-02-28T11:49:50.091085,a69ebee82a9acd54117407ca3697db0d7bfbfdac,19988,244,20232,0
labeling,2025-02-28T11:49:52.936179,a69ebee82a9acd54117407ca3697db0d7bfbfdac,20388,150,20538,0
labeling,2025-02-28T11:49:59.530482,a69ebee82a9acd54117407ca3697db0d7bfbfdac,20543,411,20954,0
labeling,2025-02-28T11:50:02.723180,a69ebee82a9acd54117407ca3697db0d7bfbfdac,1621,148,1769,0
labeling,2025-02-28T11:50:14.547539,a85dba6c75031912d56a811637f803ba4ddeb257,20272,338,20610,0
labeling,2025-02-28T11:50:16.447644,a85dba6c75031912d56a811637f803ba4ddeb257,7645,123,7768,0
labeling,2025-02-28T11:50:55.449016,aa781901e117281bfee6f8e4bea6fc9c9bada62e,20440,425,20865,0
labeling,2025-02-28T11:51:00.738850,aa781901e117281bfee6f8e4bea6fc9c9bada62e,19005,239,19244,0
labeling,2025-02-28T11:51:02.720159,aa781901e117281bfee6f8e4bea6fc9c9bada62e,20427,62,20489,0
labeling,2025-02-28T11:51:04.874113,aa781901e117281bfee6f8e4bea6fc9c9bada62e,17895,87,17982,0
labeling,2025-02-28T11:51:39.448874,ad1613dac24a1349ec293100e3ea19fe913bb930,20420,400,20820,0
labeling,2025-02-28T11:51:44.748562,ad1613dac24a1349ec293100e3ea19fe913bb930,20463,332,20795,0
labeling,2025-02-28T11:51:50.881060,ad1613dac24a1349ec293100e3ea19fe913bb930,20252,196,20448,0
labeling,2025-02-28T11:51:53.860373,ad1613dac24a1349ec293100e3ea19fe913bb930,17506,139,17645,0
labeling,2025-02-28T11:51:55.953805,ad1613dac24a1349ec293100e3ea19fe913bb930,19526,32,19558,0
labeling,2025-02-28T11:52:10.684674,b33bd2220c0fc0939ef08b1bdd8d2ebea158aa59,19943,105,20048,0
labeling,2025-02-28T11:52:13.086248,b33bd2220c0fc0939ef08b1bdd8d2ebea158aa59,19861,97,19958,0
labeling,2025-02-28T11:52:14.103356,b33bd2220c0fc0939ef08b1bdd8d2ebea158aa59,5545,34,5579,0
labeling,2025-02-28T11:52:47.426761,b3c406f0cd22d58b25d0f52852e1c4a5d73daf35,20042,545,20587,0
labeling,2025-02-28T11:52:53.430109,b3c406f0cd22d58b25d0f52852e1c4a5d73daf35,20297,160,20457,0
labeling,2025-02-28T11:53:00.596381,b3c406f0cd22d58b25d0f52852e1c4a5d73daf35,20002,563,20565,0
labeling,2025-02-28T11:53:02.814917,b3c406f0cd22d58b25d0f52852e1c4a5d73daf35,20419,101,20520,0
labeling,2025-02-28T11:53:04.341750,b3c406f0cd22d58b25d0f52852e1c4a5d73daf35,11501,70,11571,0
labeling,2025-02-28T11:53:30.445523,b947c33b370d8a3251ef9c36ce7d71e8d16f4f8e,20026,308,20334,0
labeling,2025-02-28T11:53:40.340504,b947c33b370d8a3251ef9c36ce7d71e8d16f4f8e,20368,668,21036,0
labeling,2025-02-28T11:53:43.488677,b947c33b370d8a3251ef9c36ce7d71e8d16f4f8e,19750,153,19903,0
labeling,2025-02-28T11:53:45.707778,b947c33b370d8a3251ef9c36ce7d71e8d16f4f8e,14574,116,14690,0
labeling,2025-02-28T11:54:11.972178,c06d5ad4b6408fec26675d30b37a6042c007095a,19717,342,20059,0
labeling,2025-02-28T11:54:15.731863,c06d5ad4b6408fec26675d30b37a6042c007095a,20295,170,20465,0
labeling,2025-02-28T11:54:16.713510,c06d5ad4b6408fec26675d30b37a6042c007095a,3284,27,3311,0
labeling,2025-02-28T11:55:07.908018,c5fc5890205fe5326d690fc017f7153fb09924e4,19795,516,20311,0
labeling,2025-02-28T11:55:10.077781,c5fc5890205fe5326d690fc017f7153fb09924e4,20430,73,20503,0
labeling,2025-02-28T11:55:16.314061,c5fc5890205fe5326d690fc017f7153fb09924e4,19212,474,19686,0
labeling,2025-02-28T11:55:20.257484,c5fc5890205fe5326d690fc017f7153fb09924e4,20350,182,20532,0
labeling,2025-02-28T11:55:24.927087,c5fc5890205fe5326d690fc017f7153fb09924e4,19798,237,20035,0
labeling,2025-02-28T11:55:29.586720,c5fc5890205fe5326d690fc017f7153fb09924e4,20408,278,20686,0
labeling,2025-02-28T11:55:31.423363,c5fc5890205fe5326d690fc017f7153fb09924e4,20332,66,20398,0
labeling,2025-02-28T11:55:36.631053,c5fc5890205fe5326d690fc017f7153fb09924e4,20222,407,20629,0
labeling,2025-02-28T11:55:43.604804,c5fc5890205fe5326d690fc017f7153fb09924e4,20296,469,20765,0
labeling,2025-02-28T11:55:45.559106,c5fc5890205fe5326d690fc017f7153fb09924e4,13472,71,13543,0
labeling,2025-02-28T11:59:45.551610,c74139ce26a6f803725f5074a8a0f539abb99c09,20078,694,20772,0
labeling,2025-02-28T12:00:21.867894,c74139ce26a6f803725f5074a8a0f539abb99c09,20072,503,20575,0
labeling,2025-02-28T12:00:26.947206,c74139ce26a6f803725f5074a8a0f539abb99c09,20116,205,20321,0
labeling,2025-02-28T12:00:30.745705,c74139ce26a6f803725f5074a8a0f539abb99c09,20434,248,20682,0
labeling,2025-02-28T12:00:36.617646,c74139ce26a6f803725f5074a8a0f539abb99c09,20125,279,20404,0
labeling,2025-02-28T12:00:44.667474,c74139ce26a6f803725f5074a8a0f539abb99c09,20278,331,20609,0
labeling,2025-02-28T12:00:48.050291,c74139ce26a6f803725f5074a8a0f539abb99c09,19957,82,20039,0
labeling,2025-02-28T12:00:51.718396,c74139ce26a6f803725f5074a8a0f539abb99c09,19727,152,19879,0
labeling,2025-02-28T12:00:55.960866,c74139ce26a6f803725f5074a8a0f539abb99c09,20267,117,20384,0
labeling,2025-02-28T12:01:01.244409,c74139ce26a6f803725f5074a8a0f539abb99c09,19923,324,20247,0
labeling,2025-02-28T12:01:04.147692,c74139ce26a6f803725f5074a8a0f539abb99c09,20397,112,20509,0
labeling,2025-02-28T12:01:06.738493,c74139ce26a6f803725f5074a8a0f539abb99c09,20449,114,20563,0
labeling,2025-02-28T12:01:09.449148,c74139ce26a6f803725f5074a8a0f539abb99c09,20192,108,20300,0
labeling,2025-02-28T12:01:12.221425,c74139ce26a6f803725f5074a8a0f539abb99c09,20590,93,20683,0
labeling,2025-02-28T12:01:14.492412,c74139ce26a6f803725f5074a8a0f539abb99c09,20071,69,20140,0
labeling,2025-02-28T12:01:16.654054,c74139ce26a6f803725f5074a8a0f539abb99c09,19912,37,19949,0
labeling,2025-02-28T12:01:30.146884,c74139ce26a6f803725f5074a8a0f539abb99c09,20118,636,20754,0
labeling,2025-02-28T12:01:35.211102,c74139ce26a6f803725f5074a8a0f539abb99c09,20293,265,20558,0
labeling,2025-02-28T12:01:38.686057,c74139ce26a6f803725f5074a8a0f539abb99c09,20570,185,20755,0
labeling,2025-02-28T12:01:41.021093,c74139ce26a6f803725f5074a8a0f539abb99c09,20049,76,20125,0
labeling,2025-02-28T12:01:43.076459,c74139ce26a6f803725f5074a8a0f539abb99c09,20308,82,20390,0
labeling,2025-02-28T12:01:45.067325,c74139ce26a6f803725f5074a8a0f539abb99c09,20360,69,20429,0
labeling,2025-02-28T12:01:50.672162,c74139ce26a6f803725f5074a8a0f539abb99c09,20529,336,20865,0
labeling,2025-02-28T12:01:54.610183,c74139ce26a6f803725f5074a8a0f539abb99c09,19582,157,19739,0
labeling,2025-02-28T12:01:58.304624,c74139ce26a6f803725f5074a8a0f539abb99c09,20249,151,20400,0
labeling,2025-02-28T12:02:01.780463,c74139ce26a6f803725f5074a8a0f539abb99c09,20204,162,20366,0
labeling,2025-02-28T12:02:06.173702,c74139ce26a6f803725f5074a8a0f539abb99c09,19772,260,20032,0
labeling,2025-02-28T12:02:09.356381,c74139ce26a6f803725f5074a8a0f539abb99c09,20303,160,20463,0
labeling,2025-02-28T12:02:12.661340,c74139ce26a6f803725f5074a8a0f539abb99c09,20604,133,20737,0
labeling,2025-02-28T12:02:17.889102,c74139ce26a6f803725f5074a8a0f539abb99c09,20383,142,20525,0
labeling,2025-02-28T12:02:22.421302,c74139ce26a6f803725f5074a8a0f539abb99c09,20577,35,20612,0
labeling,2025-02-28T12:02:25.863654,c74139ce26a6f803725f5074a8a0f539abb99c09,12907,88,12995,0
labeling,2025-02-28T12:02:46.795289,c7475e1d98f9a46a4652e503881d4a67232b41d3,20493,318,20811,0
labeling,2025-02-28T12:02:49.430486,c7475e1d98f9a46a4652e503881d4a67232b41d3,20295,110,20405,0
labeling,2025-02-28T12:02:51.398453,c7475e1d98f9a46a4652e503881d4a67232b41d3,13733,102,13835,0
labeling,2025-02-28T12:03:07.049448,c8af22dbedd95ee719273792e5964ab8bbba17b2,20332,422,20754,0
labeling,2025-02-28T12:03:11.200512,c8af22dbedd95ee719273792e5964ab8bbba17b2,19857,160,20017,0
labeling,2025-02-28T12:03:22.878232,c8af22dbedd95ee719273792e5964ab8bbba17b2,15869,423,16292,0
labeling,2025-02-28T12:04:07.391793,cc0fc5888b99758100a7ff024863fc4337b6b3c5,20270,346,20616,0
labeling,2025-02-28T12:04:09.423917,cc0fc5888b99758100a7ff024863fc4337b6b3c5,20044,69,20113,0
labeling,2025-02-28T12:04:18.214522,cc0fc5888b99758100a7ff024863fc4337b6b3c5,20242,303,20545,0
labeling,2025-02-28T12:04:20.434451,cc0fc5888b99758100a7ff024863fc4337b6b3c5,20123,80,20203,0
labeling,2025-02-28T12:04:25.204393,cc0fc5888b99758100a7ff024863fc4337b6b3c5,20369,256,20625,0
labeling,2025-02-28T12:04:28.728971,cc0fc5888b99758100a7ff024863fc4337b6b3c5,20584,203,20787,0
labeling,2025-02-28T12:04:33.042341,cc0fc5888b99758100a7ff024863fc4337b6b3c5,20275,199,20474,0
labeling,2025-02-28T12:04:36.047045,cc0fc5888b99758100a7ff024863fc4337b6b3c5,19918,112,20030,0
labeling,2025-02-28T12:04:40.269934,cc0fc5888b99758100a7ff024863fc4337b6b3c5,20122,216,20338,0
labeling,2025-02-28T12:04:43.264438,cc0fc5888b99758100a7ff024863fc4337b6b3c5,20110,84,20194,0
labeling,2025-02-28T12:04:47.997739,cc0fc5888b99758100a7ff024863fc4337b6b3c5,19969,97,20066,0
labeling,2025-02-28T12:04:52.877958,cc0fc5888b99758100a7ff024863fc4337b6b3c5,20056,265,20321,0
labeling,2025-02-28T12:05:06.120388,d14ae2b6284e48b5c1e6659a0a5863d84697b3b9,19947,136,20083,0
labeling,2025-02-28T12:05:12.487689,d14ae2b6284e48b5c1e6659a0a5863d84697b3b9,20404,366,20770,0
labeling,2025-02-28T12:05:14.844523,d14ae2b6284e48b5c1e6659a0a5863d84697b3b9,9975,117,10092,0
labeling,2025-02-28T12:05:53.153821,d5ad1d288230072e3f6654bb6182d76f8af2ba0a,19819,668,20487,0
labeling,2025-02-28T12:06:00.494938,d5ad1d288230072e3f6654bb6182d76f8af2ba0a,20087,459,20546,0
labeling,2025-02-28T12:06:08.286382,d5ad1d288230072e3f6654bb6182d76f8af2ba0a,20107,477,20584,0
labeling,2025-02-28T12:06:09.548149,d5ad1d288230072e3f6654bb6182d76f8af2ba0a,2337,62,2399,0
labeling,2025-02-28T12:06:33.194676,d86be8a2fa1aab721d7de6de7fd4f5267c914cb2,19914,386,20300,0
labeling,2025-02-28T12:06:36.319641,d86be8a2fa1aab721d7de6de7fd4f5267c914cb2,20001,189,20190,0
labeling,2025-02-28T12:06:45.416083,d86be8a2fa1aab721d7de6de7fd4f5267c914cb2,20429,500,20929,0
labeling,2025-02-28T12:06:48.043352,d86be8a2fa1aab721d7de6de7fd4f5267c914cb2,10528,119,10647,0
labeling,2025-02-28T12:07:33.373122,da663e46fbf02ec8a90b3f3c1079ef4c9f7907e1,20490,453,20943,0
labeling,2025-02-28T12:07:37.656402,da663e46fbf02ec8a90b3f3c1079ef4c9f7907e1,20080,310,20390,0
labeling,2025-02-28T12:07:46.147634,da663e46fbf02ec8a90b3f3c1079ef4c9f7907e1,20551,442,20993,0
labeling,2025-02-28T12:07:52.375015,da663e46fbf02ec8a90b3f3c1079ef4c9f7907e1,20432,399,20831,0
labeling,2025-02-28T12:07:53.625201,da663e46fbf02ec8a90b3f3c1079ef4c9f7907e1,9726,26,9752,0
labeling,2025-02-28T12:08:05.975154,ddd10e4612006205c4b1ba050a11648071e6e429,20190,86,20276,0
labeling,2025-02-28T12:08:08.587454,ddd10e4612006205c4b1ba050a11648071e6e429,18600,100,18700,0
labeling,2025-02-28T12:09:18.629906,ded965ce7e3ea0ad9b83272b8c36f529793a2887,20400,319,20719,0
labeling,2025-02-28T12:09:23.837468,ded965ce7e3ea0ad9b83272b8c36f529793a2887,19834,296,20130,0
labeling,2025-02-28T12:09:30.708233,ded965ce7e3ea0ad9b83272b8c36f529793a2887,19772,327,20099,0
labeling,2025-02-28T12:09:37.172229,ded965ce7e3ea0ad9b83272b8c36f529793a2887,19449,356,19805,0
labeling,2025-02-28T12:09:42.310333,ded965ce7e3ea0ad9b83272b8c36f529793a2887,20053,165,20218,0
labeling,2025-02-28T12:09:45.444538,ded965ce7e3ea0ad9b83272b8c36f529793a2887,19890,151,20041,0
labeling,2025-02-28T12:09:48.677672,ded965ce7e3ea0ad9b83272b8c36f529793a2887,19729,150,19879,0
labeling,2025-02-28T12:09:52.949202,ded965ce7e3ea0ad9b83272b8c36f529793a2887,20541,263,20804,0
labeling,2025-02-28T12:10:06.026430,ded965ce7e3ea0ad9b83272b8c36f529793a2887,20399,327,20726,0
labeling,2025-02-28T12:10:09.385514,ded965ce7e3ea0ad9b83272b8c36f529793a2887,11807,266,12073,0
labeling,2025-02-28T12:11:09.457548,e117005fc313bf0d49429d34bc8e1ef64de54898,20456,325,20781,0
labeling,2025-02-28T12:11:11.807473,e117005fc313bf0d49429d34bc8e1ef64de54898,20014,96,20110,0
labeling,2025-02-28T12:11:15.724467,e117005fc313bf0d49429d34bc8e1ef64de54898,20174,189,20363,0
labeling,2025-02-28T12:11:21.657524,e117005fc313bf0d49429d34bc8e1ef64de54898,18930,138,19068,0
labeling,2025-02-28T12:11:23.537379,e117005fc313bf0d49429d34bc8e1ef64de54898,9644,95,9739,0
labeling,2025-02-28T12:11:48.345775,e1edf72618e9d6ae2e72bb3ac7a9ddc15240e4ef,20050,296,20346,0
labeling,2025-02-28T12:11:51.180163,e1edf72618e9d6ae2e72bb3ac7a9ddc15240e4ef,19793,130,19923,0
labeling,2025-02-28T12:11:54.963885,e1edf72618e9d6ae2e72bb3ac7a9ddc15240e4ef,20362,90,20452,0
labeling,2025-02-28T12:11:59.326589,e1edf72618e9d6ae2e72bb3ac7a9ddc15240e4ef,19961,219,20180,0
labeling,2025-02-28T12:12:01.056614,e1edf72618e9d6ae2e72bb3ac7a9ddc15240e4ef,16526,65,16591,0
labeling,2025-02-28T12:12:31.214023,e21ac6c083a56192fab027ebd2ab0fad71de5d7d,20452,490,20942,0
labeling,2025-02-28T12:12:38.964615,e21ac6c083a56192fab027ebd2ab0fad71de5d7d,20270,388,20658,0
labeling,2025-02-28T12:12:44.959172,e21ac6c083a56192fab027ebd2ab0fad71de5d7d,19953,225,20178,0
labeling,2025-02-28T12:12:47.424682,e21ac6c083a56192fab027ebd2ab0fad71de5d7d,20552,83,20635,0
labeling,2025-02-28T12:12:51.760686,e21ac6c083a56192fab027ebd2ab0fad71de5d7d,20503,249,20752,0
labeling,2025-02-28T12:12:53.413460,e21ac6c083a56192fab027ebd2ab0fad71de5d7d,10591,26,10617,0
labeling,2025-02-28T12:13:17.991251,e229fc9f5c694e93b02ac312c231607a04e3e528,19722,103,19825,0
labeling,2025-02-28T12:13:27.076581,e229fc9f5c694e93b02ac312c231607a04e3e528,19481,149,19630,0
labeling,2025-02-28T12:13:30.230652,e229fc9f5c694e93b02ac312c231607a04e3e528,19601,180,19781,0
labeling,2025-02-28T12:13:32.469627,e229fc9f5c694e93b02ac312c231607a04e3e528,20045,90,20135,0
labeling,2025-02-28T12:13:35.181776,e229fc9f5c694e93b02ac312c231607a04e3e528,11754,167,11921,0
labeling,2025-02-28T12:14:13.091087,e273ed0d9626b9feaf50c09405c2b70d461e41d7,20070,461,20531,0
labeling,2025-02-28T12:14:20.929518,e273ed0d9626b9feaf50c09405c2b70d461e41d7,19656,496,20152,0
labeling,2025-02-28T12:14:27.310216,e273ed0d9626b9feaf50c09405c2b70d461e41d7,20450,434,20884,0
labeling,2025-02-28T12:14:40.358208,e2850fff8d9dee77f3a6520d0b1aba46adddc2c0,20128,217,20345,0
labeling,2025-02-28T12:14:42.717320,e2850fff8d9dee77f3a6520d0b1aba46adddc2c0,4495,123,4618,0
labeling,2025-02-28T12:15:06.073445,e2923f240db86d0096f462f6cb398339d3251b50,20524,219,20743,0
labeling,2025-02-28T12:15:08.506730,e2923f240db86d0096f462f6cb398339d3251b50,19873,102,19975,0
labeling,2025-02-28T12:15:11.931072,e2923f240db86d0096f462f6cb398339d3251b50,20433,105,20538,0
labeling,2025-02-28T12:15:13.969962,e2923f240db86d0096f462f6cb398339d3251b50,20032,68,20100,0
labeling,2025-02-28T12:15:15.857280,e2923f240db86d0096f462f6cb398339d3251b50,9788,83,9871,0
labeling,2025-02-28T12:15:42.735349,e30ece688caf7602b734bbbcf39559b4acdb2739,20011,648,20659,0
labeling,2025-02-28T12:15:49.877863,e30ece688caf7602b734bbbcf39559b4acdb2739,19180,117,19297,0
labeling,2025-02-28T12:15:53.414954,e30ece688caf7602b734bbbcf39559b4acdb2739,20484,76,20560,0
labeling,2025-02-28T12:15:56.376444,e30ece688caf7602b734bbbcf39559b4acdb2739,20412,112,20524,0
labeling,2025-02-28T12:15:59.320095,e30ece688caf7602b734bbbcf39559b4acdb2739,20300,125,20425,0
labeling,2025-02-28T12:16:01.218584,e30ece688caf7602b734bbbcf39559b4acdb2739,13650,81,13731,0
labeling,2025-02-28T12:16:59.215502,e6ce8ed579e95d2cfeabbbed872beb0c3f8396d7,19952,146,20098,0
labeling,2025-02-28T12:17:06.076456,e6ce8ed579e95d2cfeabbbed872beb0c3f8396d7,20036,480,20516,0
labeling,2025-02-28T12:17:08.738698,e6ce8ed579e95d2cfeabbbed872beb0c3f8396d7,19564,132,19696,0
labeling,2025-02-28T12:17:15.806927,e6ce8ed579e95d2cfeabbbed872beb0c3f8396d7,19755,460,20215,0
labeling,2025-02-28T12:17:20.687937,e6ce8ed579e95d2cfeabbbed872beb0c3f8396d7,19837,306,20143,0
labeling,2025-02-28T12:17:25.390498,e6ce8ed579e95d2cfeabbbed872beb0c3f8396d7,20334,316,20650,0
labeling,2025-02-28T12:17:30.030608,e6ce8ed579e95d2cfeabbbed872beb0c3f8396d7,7249,381,7630,0
labeling,2025-02-28T12:18:13.723756,e7a45fed0d7ebfd13a524e7fcc443318bac654e2,19538,473,20011,0
labeling,2025-02-28T12:18:17.727015,e7a45fed0d7ebfd13a524e7fcc443318bac654e2,20243,81,20324,0
labeling,2025-02-28T12:18:24.704738,e7a45fed0d7ebfd13a524e7fcc443318bac654e2,19475,370,19845,0
labeling,2025-02-28T12:18:35.837632,e7a45fed0d7ebfd13a524e7fcc443318bac654e2,19898,423,20321,0
labeling,2025-02-28T12:18:38.587254,e7a45fed0d7ebfd13a524e7fcc443318bac654e2,20112,106,20218,0
labeling,2025-02-28T12:18:44.277124,e7a45fed0d7ebfd13a524e7fcc443318bac654e2,20551,181,20732,0
labeling,2025-02-28T12:18:48.544929,e7a45fed0d7ebfd13a524e7fcc443318bac654e2,11250,312,11562,0
labeling,2025-02-28T12:19:12.245334,e7f655f43bc2abf6216519187d9fc907e9224937,19687,158,19845,0
labeling,2025-02-28T12:19:15.416265,e7f655f43bc2abf6216519187d9fc907e9224937,20000,116,20116,0
labeling,2025-02-28T12:19:21.529528,e7f655f43bc2abf6216519187d9fc907e9224937,19077,159,19236,0
labeling,2025-02-28T12:19:23.572379,e7f655f43bc2abf6216519187d9fc907e9224937,20150,69,20219,0
labeling,2025-02-28T12:19:26.827405,e7f655f43bc2abf6216519187d9fc907e9224937,20331,197,20528,0
labeling,2025-02-28T12:19:30.936601,e7f655f43bc2abf6216519187d9fc907e9224937,19801,224,20025,0
labeling,2025-02-28T12:19:31.935176,e7f655f43bc2abf6216519187d9fc907e9224937,4248,28,4276,0
labeling,2025-02-28T12:20:03.711910,ecabab4934d4b80570c4bb3b8e35b7476694b3fb,19678,200,19878,0
labeling,2025-02-28T12:20:10.160154,ecabab4934d4b80570c4bb3b8e35b7476694b3fb,20202,222,20424,0
labeling,2025-02-28T12:20:12.446976,ecabab4934d4b80570c4bb3b8e35b7476694b3fb,20142,102,20244,0
labeling,2025-02-28T12:20:18.537159,ecabab4934d4b80570c4bb3b8e35b7476694b3fb,20567,370,20937,0
labeling,2025-02-28T12:20:25.991431,ecabab4934d4b80570c4bb3b8e35b7476694b3fb,19863,463,20326,0
labeling,2025-02-28T12:20:28.224684,ecabab4934d4b80570c4bb3b8e35b7476694b3fb,18397,106,18503,0
labeling,2025-02-28T12:20:30.576474,ecabab4934d4b80570c4bb3b8e35b7476694b3fb,8302,129,8431,0
labeling,2025-02-28T12:20:43.903376,f015d4bfeec43fe65c003b6f4420ae864efbb58f,19977,366,20343,0
labeling,2025-02-28T12:20:50.246221,f015d4bfeec43fe65c003b6f4420ae864efbb58f,19990,383,20373,0
labeling,2025-02-28T12:21:02.630231,f015d4bfeec43fe65c003b6f4420ae864efbb58f,5163,395,5558,0
labeling,2025-02-28T12:21:21.874688,f6a1077a46cb36761604f8f4840698e22837f5f7,20303,328,20631,0
labeling,2025-02-28T12:21:31.075679,f6a1077a46cb36761604f8f4840698e22837f5f7,11944,271,12215,0
labeling,2025-02-28T12:22:22.615522,f7324f3868005b3aae6aafd30441c9bb6c8823e8,19942,440,20382,0
labeling,2025-02-28T12:22:27.001185,f7324f3868005b3aae6aafd30441c9bb6c8823e8,19881,236,20117,0
labeling,2025-02-28T12:22:30.808322,f7324f3868005b3aae6aafd30441c9bb6c8823e8,19739,211,19950,0
labeling,2025-02-28T12:22:40.839051,f7324f3868005b3aae6aafd30441c9bb6c8823e8,19489,439,19928,0
labeling,2025-02-28T12:22:42.943596,f7324f3868005b3aae6aafd30441c9bb6c8823e8,20257,88,20345,0
labeling,2025-02-28T12:22:46.827607,f7324f3868005b3aae6aafd30441c9bb6c8823e8,19825,153,19978,0
labeling,2025-02-28T12:22:49.886619,f7324f3868005b3aae6aafd30441c9bb6c8823e8,19728,86,19814,0
labeling,2025-02-28T12:22:52.385463,f7324f3868005b3aae6aafd30441c9bb6c8823e8,20315,71,20386,0
labeling,2025-02-28T12:22:54.621989,f7324f3868005b3aae6aafd30441c9bb6c8823e8,19258,72,19330,0
labeling,2025-02-28T12:22:58.835836,f7324f3868005b3aae6aafd30441c9bb6c8823e8,19765,277,20042,0
labeling,2025-02-28T12:23:40.108043,f85f0ccbbc59f1423d52d44e5ab70e3a01164499,19805,228,20033,0
labeling,2025-02-28T12:23:44.025016,f85f0ccbbc59f1423d52d44e5ab70e3a01164499,20298,107,20405,0
labeling,2025-02-28T12:23:47.327904,f85f0ccbbc59f1423d52d44e5ab70e3a01164499,19703,178,19881,0
labeling,2025-02-28T12:23:51.218190,f85f0ccbbc59f1423d52d44e5ab70e3a01164499,20341,197,20538,0
labeling,2025-02-28T12:23:55.478528,f85f0ccbbc59f1423d52d44e5ab70e3a01164499,20440,224,20664,0
labeling,2025-02-28T12:23:58.378232,f85f0ccbbc59f1423d52d44e5ab70e3a01164499,20062,119,20181,0
labeling,2025-02-28T12:24:00.200085,f85f0ccbbc59f1423d52d44e5ab70e3a01164499,20205,36,20241,0
labeling,2025-02-28T12:24:07.243666,f85f0ccbbc59f1423d52d44e5ab70e3a01164499,13968,177,14145,0
labeling,2025-02-28T12:24:24.775258,f879b3a802ccd6e8e6ca0a07ed8464318b7c0724,20461,279,20740,0
labeling,2025-02-28T12:24:29.167152,f879b3a802ccd6e8e6ca0a07ed8464318b7c0724,17211,234,17445,0
labeling,2025-02-28T12:25:06.910475,f9736aa2f56c40b127bced09ce1c8e8cbf7aa0e3,20354,223,20577,0
labeling,2025-02-28T12:25:12.897869,f9736aa2f56c40b127bced09ce1c8e8cbf7aa0e3,20534,268,20802,0
labeling,2025-02-28T12:25:17.541142,f9736aa2f56c40b127bced09ce1c8e8cbf7aa0e3,19902,213,20115,0
labeling,2025-02-28T12:25:21.101992,f9736aa2f56c40b127bced09ce1c8e8cbf7aa0e3,19935,194,20129,0
labeling,2025-02-28T12:25:24.155885,f9736aa2f56c40b127bced09ce1c8e8cbf7aa0e3,20452,110,20562,0
labeling,2025-02-28T12:25:31.135340,f9736aa2f56c40b127bced09ce1c8e8cbf7aa0e3,17939,185,18124,0
filter_labels,2025-02-28T13:44:46.518194,ecabab4934d4b80570c4bb3b8e35b7476694b3fb,2279,65,2344,0
answer_question,2025-02-28T13:44:51.596795,ecabab4934d4b80570c4bb3b8e35b7476694b3fb,2390,116,2506,0
filter_labels,2025-02-28T13:44:54.642367,446545ae548543d8744f8d885ff75face3424ba4,822,71,893,0
answer_question,2025-02-28T13:45:01.604170,446545ae548543d8744f8d885ff75face3424ba4,2373,186,2559,0
filter_labels,2025-02-28T13:45:03.904438,9e794a58e511f6a6a9a13b201d652deff9f9f69a,4483,96,4579,0
answer_question,2025-02-28T13:45:21.521802,9e794a58e511f6a6a9a13b201d652deff9f9f69a,12192,485,12677,0
filter_labels,2025-02-28T13:45:23.740996,92d9de8e4db96e0b95a484afcd1c54c6beb62c03,1212,61,1273,0
answer_question,2025-02-28T13:45:31.260546,92d9de8e4db96e0b95a484afcd1c54c6beb62c03,2774,161,2935,2688
filter_labels,2025-02-28T13:45:32.221357,ddd10e4612006205c4b1ba050a11648071e6e429,518,39,557,0
answer_question,2025-02-28T13:45:35.095947,ddd10e4612006205c4b1ba050a11648071e6e429,3623,73,3696,3584
filter_labels,2025-02-28T13:45:36.322964,682de8e45fd9688f3452bc0e18257132a8f3cff6,1364,58,1422,0
answer_question,2025-02-28T13:45:40.834026,682de8e45fd9688f3452bc0e18257132a8f3cff6,2792,110,2902,2688
filter_labels,2025-02-28T13:45:42.502971,c74139ce26a6f803725f5074a8a0f539abb99c09,7940,79,8019,0
labeling,2025-02-28T13:57:11.874820,682de8e45fd9688f3452bc0e18257132a8f3cff6,20494,265,20759,0
labeling,2025-02-28T13:57:13.366082,682de8e45fd9688f3452bc0e18257132a8f3cff6,20383,30,20413,0
labeling,2025-02-28T13:57:20.937105,682de8e45fd9688f3452bc0e18257132a8f3cff6,20709,465,21174,0
labeling,2025-02-28T13:57:24.296845,682de8e45fd9688f3452bc0e18257132a8f3cff6,20202,199,20401,0
labeling,2025-02-28T13:57:31.060919,682de8e45fd9688f3452bc0e18257132a8f3cff6,19871,453,20324,0
labeling,2025-02-28T13:57:37.776865,682de8e45fd9688f3452bc0e18257132a8f3cff6,13393,628,14021,0
labeling,2025-02-28T14:00:45.433379,682de8e45fd9688f3452bc0e18257132a8f3cff6,20494,409,20903,0
labeling,2025-02-28T14:00:51.074655,682de8e45fd9688f3452bc0e18257132a8f3cff6,20383,30,20413,0
labeling,2025-02-28T14:00:57.775338,682de8e45fd9688f3452bc0e18257132a8f3cff6,20709,283,20992,0
labeling,2025-02-28T14:01:06.297116,682de8e45fd9688f3452bc0e18257132a8f3cff6,20202,240,20442,0
labeling,2025-02-28T14:01:10.233898,682de8e45fd9688f3452bc0e18257132a8f3cff6,19871,252,20123,0
labeling,2025-02-28T14:01:14.930717,682de8e45fd9688f3452bc0e18257132a8f3cff6,13393,221,13614,0
labeling,2025-02-28T14:04:41.683743,0a61a353b1ea9fd9b8f63b60239634ca3007d58f,20689,303,20992,0
labeling,2025-02-28T14:04:47.149814,0a61a353b1ea9fd9b8f63b60239634ca3007d58f,20599,229,20828,0
labeling,2025-02-28T14:04:59.089495,0a61a353b1ea9fd9b8f63b60239634ca3007d58f,19910,299,20209,0
labeling,2025-02-28T14:05:09.472504,0a61a353b1ea9fd9b8f63b60239634ca3007d58f,20221,669,20890,0
labeling,2025-02-28T14:05:12.932406,0a61a353b1ea9fd9b8f63b60239634ca3007d58f,20442,202,20644,0
labeling,2025-02-28T14:05:15.857478,0a61a353b1ea9fd9b8f63b60239634ca3007d58f,9032,145,9177,0
labeling,2025-02-28T14:08:39.795437,0a61a353b1ea9fd9b8f63b60239634ca3007d58f,20709,290,20999,0
labeling,2025-02-28T14:08:45.078463,0a61a353b1ea9fd9b8f63b60239634ca3007d58f,20619,281,20900,0
labeling,2025-02-28T14:08:53.675186,0a61a353b1ea9fd9b8f63b60239634ca3007d58f,19930,585,20515,0
labeling,2025-02-28T14:08:56.841991,0a61a353b1ea9fd9b8f63b60239634ca3007d58f,20241,191,20432,0
labeling,2025-02-28T14:08:59.849779,0a61a353b1ea9fd9b8f63b60239634ca3007d58f,20462,115,20577,0
labeling,2025-02-28T14:09:02.082334,0a61a353b1ea9fd9b8f63b60239634ca3007d58f,9052,118,9170,0
labeling,2025-02-28T14:12:11.806450,0a61a353b1ea9fd9b8f63b60239634ca3007d58f,20627,107,20734,0
labeling,2025-02-28T14:12:20.391980,0a61a353b1ea9fd9b8f63b60239634ca3007d58f,20537,379,20916,0
labeling,2025-02-28T14:12:26.860269,0a61a353b1ea9fd9b8f63b60239634ca3007d58f,19848,282,20130,0
labeling,2025-02-28T14:12:30.159055,0a61a353b1ea9fd9b8f63b60239634ca3007d58f,20159,166,20325,0
labeling,2025-02-28T14:12:36.462923,0a61a353b1ea9fd9b8f63b60239634ca3007d58f,20380,372,20752,0
labeling,2025-02-28T14:12:39.197742,0a61a353b1ea9fd9b8f63b60239634ca3007d58f,8970,106,9076,0
labeling,2025-02-28T14:13:20.236562,682de8e45fd9688f3452bc0e18257132a8f3cff6,20432,463,20895,0
labeling,2025-02-28T14:13:37.249744,682de8e45fd9688f3452bc0e18257132a8f3cff6,20321,555,20876,0
labeling,2025-02-28T14:13:41.577117,682de8e45fd9688f3452bc0e18257132a8f3cff6,20647,265,20912,0
labeling,2025-02-28T14:13:45.781483,682de8e45fd9688f3452bc0e18257132a8f3cff6,20140,226,20366,0
labeling,2025-02-28T14:13:49.971681,682de8e45fd9688f3452bc0e18257132a8f3cff6,19809,206,20015,0
labeling,2025-02-28T14:14:00.173366,682de8e45fd9688f3452bc0e18257132a8f3cff6,13331,326,13657,0
labeling,2025-02-28T14:15:26.767836,0a61a353b1ea9fd9b8f63b60239634ca3007d58f,20768,741,21509,0
labeling,2025-02-28T14:15:30.876768,0a61a353b1ea9fd9b8f63b60239634ca3007d58f,20678,189,20867,0
labeling,2025-02-28T14:15:36.732353,0a61a353b1ea9fd9b8f63b60239634ca3007d58f,19989,204,20193,0
labeling,2025-02-28T14:15:41.552636,0a61a353b1ea9fd9b8f63b60239634ca3007d58f,20300,220,20520,0
labeling,2025-02-28T14:15:51.637993,0a61a353b1ea9fd9b8f63b60239634ca3007d58f,20521,166,20687,0
labeling,2025-02-28T14:15:53.667790,0a61a353b1ea9fd9b8f63b60239634ca3007d58f,9111,88,9199,0
labeling,2025-02-28T14:16:39.941437,682de8e45fd9688f3452bc0e18257132a8f3cff6,20573,594,21167,0
labeling,2025-02-28T14:16:43.158965,682de8e45fd9688f3452bc0e18257132a8f3cff6,20462,162,20624,0
labeling,2025-02-28T14:16:46.144875,682de8e45fd9688f3452bc0e18257132a8f3cff6,20788,151,20939,0
filter_labels,2025-02-28T14:16:48.976816,ecabab4934d4b80570c4bb3b8e35b7476694b3fb,2279,106,2385,0
labeling,2025-02-28T14:16:50.473341,682de8e45fd9688f3452bc0e18257132a8f3cff6,20281,236,20517,0
answer_question,2025-02-28T14:16:52.614404,ecabab4934d4b80570c4bb3b8e35b7476694b3fb,2494,82,2576,0
labeling,2025-02-28T14:16:54.807439,682de8e45fd9688f3452bc0e18257132a8f3cff6,19950,204,20154,0
filter_labels,2025-02-28T14:16:55.484445,446545ae548543d8744f8d885ff75face3424ba4,822,61,883,0
labeling,2025-02-28T14:17:00.136355,682de8e45fd9688f3452bc0e18257132a8f3cff6,13472,207,13679,0
answer_question,2025-02-28T14:17:00.239509,446545ae548543d8744f8d885ff75face3424ba4,1712,120,1832,0
filter_labels,2025-02-28T14:17:06.339945,9e794a58e511f6a6a9a13b201d652deff9f9f69a,4483,76,4559,0
answer_question,2025-02-28T14:17:15.053120,9e794a58e511f6a6a9a13b201d652deff9f9f69a,5054,226,5280,0
filter_labels,2025-02-28T14:17:16.060614,92d9de8e4db96e0b95a484afcd1c54c6beb62c03,1212,53,1265,0
answer_question,2025-02-28T14:17:20.846505,92d9de8e4db96e0b95a484afcd1c54c6beb62c03,2766,143,2909,0
filter_labels,2025-02-28T14:17:21.853700,ddd10e4612006205c4b1ba050a11648071e6e429,518,54,572,0
answer_question,2025-02-28T14:17:25.574702,ddd10e4612006205c4b1ba050a11648071e6e429,3638,65,3703,0
filter_labels,2025-02-28T14:17:26.883318,682de8e45fd9688f3452bc0e18257132a8f3cff6,2169,75,2244,0
answer_question,2025-02-28T14:17:30.788998,682de8e45fd9688f3452bc0e18257132a8f3cff6,3179,67,3246,0
filter_labels,2025-02-28T14:17:32.344473,c74139ce26a6f803725f5074a8a0f539abb99c09,7940,74,8014,0
answer_question,2025-02-28T14:17:42.502587,c74139ce26a6f803725f5074a8a0f539abb99c09,9926,75,10001,0
filter_labels,2025-02-28T14:17:43.470552,e117005fc313bf0d49429d34bc8e1ef64de54898,1340,49,1389,0
labeling,2025-02-28T14:20:16.807475,0279901b645e568591ad95dac2c2bf939ef0c00d,20763,548,21311,0
labeling,2025-02-28T14:20:19.351134,0279901b645e568591ad95dac2c2bf939ef0c00d,20587,103,20690,0
labeling,2025-02-28T14:20:24.996245,0279901b645e568591ad95dac2c2bf939ef0c00d,20241,343,20584,0
labeling,2025-02-28T14:20:33.847356,0279901b645e568591ad95dac2c2bf939ef0c00d,20049,549,20598,0
labeling,2025-02-28T14:20:46.451151,0279901b645e568591ad95dac2c2bf939ef0c00d,19971,581,20552,0
labeling,2025-02-28T14:20:51.327155,0279901b645e568591ad95dac2c2bf939ef0c00d,20463,321,20784,0
labeling,2025-02-28T14:20:53.805773,0279901b645e568591ad95dac2c2bf939ef0c00d,20824,115,20939,0
labeling,2025-02-28T14:20:54.852611,0279901b645e568591ad95dac2c2bf939ef0c00d,1588,30,1618,0
labeling,2025-02-28T14:21:22.705726,0981826b4b43a88920f3e01c71ae73539bab84cc,20797,289,21086,0
labeling,2025-02-28T14:21:31.981085,0981826b4b43a88920f3e01c71ae73539bab84cc,19954,388,20342,0
labeling,2025-02-28T14:22:00.025790,0981826b4b43a88920f3e01c71ae73539bab84cc,20618,333,20951,0
labeling,2025-02-28T14:22:05.610086,0981826b4b43a88920f3e01c71ae73539bab84cc,20697,132,20829,0
labeling,2025-02-28T14:22:08.901646,0981826b4b43a88920f3e01c71ae73539bab84cc,12095,112,12207,0
labeling,2025-02-28T14:22:55.363045,0a61a353b1ea9fd9b8f63b60239634ca3007d58f,20768,485,21253,0
labeling,2025-02-28T14:23:01.130169,0a61a353b1ea9fd9b8f63b60239634ca3007d58f,20678,386,21064,0
labeling,2025-02-28T14:23:04.304589,0a61a353b1ea9fd9b8f63b60239634ca3007d58f,19989,174,20163,0
labeling,2025-02-28T14:23:08.351636,0a61a353b1ea9fd9b8f63b60239634ca3007d58f,20300,117,20417,0
labeling,2025-02-28T14:23:13.545148,0a61a353b1ea9fd9b8f63b60239634ca3007d58f,20521,256,20777,0
labeling,2025-02-28T14:23:20.137834,0a61a353b1ea9fd9b8f63b60239634ca3007d58f,9111,188,9299,0
labeling,2025-02-28T14:23:42.692675,0c0faea14d108e1617f2d6d2a7c1aae04eb88fe0,20551,103,20654,0
labeling,2025-02-28T14:23:45.836928,0c0faea14d108e1617f2d6d2a7c1aae04eb88fe0,20446,140,20586,0
labeling,2025-02-28T14:23:47.562110,0c0faea14d108e1617f2d6d2a7c1aae04eb88fe0,2479,87,2566,0
labeling,2025-02-28T14:24:17.085022,0f111d244aee3d976684995a222fa177a64571c4,20607,489,21096,0
labeling,2025-02-28T14:24:19.738508,0f111d244aee3d976684995a222fa177a64571c4,19921,107,20028,0
labeling,2025-02-28T14:24:26.930503,0f111d244aee3d976684995a222fa177a64571c4,20215,432,20647,0
labeling,2025-02-28T14:24:31.433974,0f111d244aee3d976684995a222fa177a64571c4,17764,263,18027,0
labeling,2025-02-28T14:24:41.077462,105688726e097505beef4934896193ac51295037,20736,315,21051,0
labeling,2025-02-28T14:24:47.825403,105688726e097505beef4934896193ac51295037,8119,435,8554,0
labeling,2025-02-28T14:25:09.754768,12bff07b957b1c8f8cad9d917ca18005720cce9b,20062,314,20376,0
labeling,2025-02-28T14:25:26.379381,12bff07b957b1c8f8cad9d917ca18005720cce9b,20415,528,20943,0
labeling,2025-02-28T14:25:28.636918,12bff07b957b1c8f8cad9d917ca18005720cce9b,6355,139,6494,0
labeling,2025-02-28T14:25:53.880422,13999998018cc53440310d94a26d1e8957e2277f,20734,446,21180,0
labeling,2025-02-28T14:25:56.510376,13999998018cc53440310d94a26d1e8957e2277f,20047,84,20131,0
labeling,2025-02-28T14:26:02.551390,13999998018cc53440310d94a26d1e8957e2277f,20742,330,21072,0
labeling,2025-02-28T14:26:06.235172,13999998018cc53440310d94a26d1e8957e2277f,20787,216,21003,0
labeling,2025-02-28T14:26:10.624547,13999998018cc53440310d94a26d1e8957e2277f,3873,326,4199,0
labeling,2025-02-28T14:27:04.091891,14fa568899745270c4ff2c10073f97f2c2e7764b,20783,641,21424,0
labeling,2025-02-28T14:27:13.483788,14fa568899745270c4ff2c10073f97f2c2e7764b,20144,412,20556,0
labeling,2025-02-28T14:27:16.781279,14fa568899745270c4ff2c10073f97f2c2e7764b,20762,149,20911,0
labeling,2025-02-28T14:27:26.062058,14fa568899745270c4ff2c10073f97f2c2e7764b,20298,633,20931,0
labeling,2025-02-28T14:27:30.850470,14fa568899745270c4ff2c10073f97f2c2e7764b,19046,176,19222,0
labeling,2025-02-28T14:27:32.270557,14fa568899745270c4ff2c10073f97f2c2e7764b,5160,76,5236,0
labeling,2025-02-28T14:28:20.559197,1a12ef3f11a64e92eeca39e493a17d2860c014a6,19639,403,20042,0
labeling,2025-02-28T14:28:30.731668,1a12ef3f11a64e92eeca39e493a17d2860c014a6,20762,786,21548,0
labeling,2025-02-28T14:28:41.546904,1a12ef3f11a64e92eeca39e493a17d2860c014a6,20539,531,21070,0
labeling,2025-02-28T14:28:47.521322,1a12ef3f11a64e92eeca39e493a17d2860c014a6,20226,402,20628,0
labeling,2025-02-28T14:28:50.799746,1a12ef3f11a64e92eeca39e493a17d2860c014a6,19440,170,19610,0
labeling,2025-02-28T14:30:06.272246,1ab89c81bdb49d4bfba2202eeb8e1c93bed414c7,20298,548,20846,0
labeling,2025-02-28T14:30:13.930640,1ab89c81bdb49d4bfba2202eeb8e1c93bed414c7,20462,627,21089,0
labeling,2025-02-28T14:30:28.652669,1ab89c81bdb49d4bfba2202eeb8e1c93bed414c7,20515,977,21492,0
labeling,2025-02-28T14:30:36.535087,1ab89c81bdb49d4bfba2202eeb8e1c93bed414c7,20380,559,20939,0
labeling,2025-02-28T14:30:40.262110,1ab89c81bdb49d4bfba2202eeb8e1c93bed414c7,20770,117,20887,0
labeling,2025-02-28T14:30:44.866960,1ab89c81bdb49d4bfba2202eeb8e1c93bed414c7,20500,148,20648,0
labeling,2025-02-28T14:30:48.609306,1ab89c81bdb49d4bfba2202eeb8e1c93bed414c7,20571,173,20744,0
labeling,2025-02-28T14:31:24.498483,1ab89c81bdb49d4bfba2202eeb8e1c93bed414c7,20228,511,20739,0
labeling,2025-02-28T14:31:30.233924,1ab89c81bdb49d4bfba2202eeb8e1c93bed414c7,20527,235,20762,0
labeling,2025-02-28T14:31:32.494745,1ab89c81bdb49d4bfba2202eeb8e1c93bed414c7,19937,82,20019,0
labeling,2025-02-28T14:31:51.287493,1ab89c81bdb49d4bfba2202eeb8e1c93bed414c7,11805,484,12289,0
labeling,2025-02-28T14:32:13.773849,1af8f906e34af6e0acfe4f73e37093bbe34700f3,20444,744,21188,0
labeling,2025-02-28T14:32:18.879456,1af8f906e34af6e0acfe4f73e37093bbe34700f3,20642,139,20781,0
labeling,2025-02-28T14:32:22.465352,1af8f906e34af6e0acfe4f73e37093bbe34700f3,14956,225,15181,0
labeling,2025-02-28T14:32:50.239446,1bd670f9cdf088266db849722c3aded77a2f4894,20396,1044,21440,0
labeling,2025-02-28T14:32:59.784748,1bd670f9cdf088266db849722c3aded77a2f4894,20576,588,21164,0
labeling,2025-02-28T14:33:08.953245,1bd670f9cdf088266db849722c3aded77a2f4894,17817,689,18506,0
labeling,2025-02-28T15:26:41.915355,23b2c590c4887dfb86761730dd7156fe3b216ab7,19934,474,20408,0
labeling,2025-02-28T15:26:47.228566,23b2c590c4887dfb86761730dd7156fe3b216ab7,20500,231,20731,0
labeling,2025-02-28T15:26:53.799071,23b2c590c4887dfb86761730dd7156fe3b216ab7,20511,361,20872,0
labeling,2025-02-28T15:27:01.275571,23b2c590c4887dfb86761730dd7156fe3b216ab7,19695,567,20262,0
labeling,2025-02-28T15:27:04.970522,23b2c590c4887dfb86761730dd7156fe3b216ab7,20767,132,20899,0
labeling,2025-02-28T15:27:16.741656,23b2c590c4887dfb86761730dd7156fe3b216ab7,15354,538,15892,0
labeling,2025-02-28T15:27:41.653682,2cdfd39bbf896b0f6651ebb0fe697cdf8c7ef0e8,20244,314,20558,0
labeling,2025-02-28T15:27:51.756795,2cdfd39bbf896b0f6651ebb0fe697cdf8c7ef0e8,20301,656,20957,0
labeling,2025-02-28T15:27:56.125397,2cdfd39bbf896b0f6651ebb0fe697cdf8c7ef0e8,20315,215,20530,0
labeling,2025-02-28T15:27:59.514222,2cdfd39bbf896b0f6651ebb0fe697cdf8c7ef0e8,20463,173,20636,0
labeling,2025-02-28T15:28:00.955801,2cdfd39bbf896b0f6651ebb0fe697cdf8c7ef0e8,13445,39,13484,0
labeling,2025-02-28T15:28:49.085315,2db41ba86cc015db1f5f7de00b764a06e6de3dcc,20079,427,20506,0
labeling,2025-02-28T15:28:53.897536,2db41ba86cc015db1f5f7de00b764a06e6de3dcc,20041,387,20428,0
labeling,2025-02-28T15:28:55.811818,2db41ba86cc015db1f5f7de00b764a06e6de3dcc,20665,73,20738,0
labeling,2025-02-28T15:28:58.011872,2db41ba86cc015db1f5f7de00b764a06e6de3dcc,20535,99,20634,0
labeling,2025-02-28T15:29:00.767333,2db41ba86cc015db1f5f7de00b764a06e6de3dcc,20707,104,20811,0
labeling,2025-02-28T15:29:02.972760,2db41ba86cc015db1f5f7de00b764a06e6de3dcc,20140,86,20226,0
labeling,2025-02-28T15:29:10.930402,2db41ba86cc015db1f5f7de00b764a06e6de3dcc,20588,476,21064,0
labeling,2025-02-28T15:29:16.801977,2db41ba86cc015db1f5f7de00b764a06e6de3dcc,20648,237,20885,0
labeling,2025-02-28T15:29:18.817656,2db41ba86cc015db1f5f7de00b764a06e6de3dcc,17267,89,17356,0
labeling,2025-02-28T15:29:55.887118,2e315764be39701457b88c23f70c5ddede4b2453,20736,794,21530,0
labeling,2025-02-28T15:29:58.629446,2e315764be39701457b88c23f70c5ddede4b2453,20805,146,20951,0
labeling,2025-02-28T15:30:06.741388,2e315764be39701457b88c23f70c5ddede4b2453,20789,145,20934,0
labeling,2025-02-28T15:30:15.008758,2e315764be39701457b88c23f70c5ddede4b2453,20353,366,20719,0
labeling,2025-02-28T15:30:21.672597,2e315764be39701457b88c23f70c5ddede4b2453,18671,204,18875,0
labeling,2025-02-28T15:31:06.833770,2fd79ae4ebe4943384c119eb1d1e9286ba3c5074,20581,777,21358,0
labeling,2025-02-28T15:31:19.014675,2fd79ae4ebe4943384c119eb1d1e9286ba3c5074,20804,595,21399,0
labeling,2025-02-28T15:31:28.154295,2fd79ae4ebe4943384c119eb1d1e9286ba3c5074,19763,585,20348,0
labeling,2025-02-28T15:31:37.151048,2fd79ae4ebe4943384c119eb1d1e9286ba3c5074,20487,484,20971,0
labeling,2025-02-28T15:31:38.331567,2fd79ae4ebe4943384c119eb1d1e9286ba3c5074,2437,34,2471,0
labeling,2025-02-28T15:32:07.823288,30f64d1043f4cb425eb636763580ae27094ffef1,20587,133,20720,0
labeling,2025-02-28T15:32:14.794688,30f64d1043f4cb425eb636763580ae27094ffef1,20550,524,21074,0
labeling,2025-02-28T15:32:26.406737,30f64d1043f4cb425eb636763580ae27094ffef1,20587,655,21242,0
labeling,2025-02-28T15:32:30.642697,30f64d1043f4cb425eb636763580ae27094ffef1,15683,115,15798,0
labeling,2025-02-28T15:33:02.245358,31a60b930e0f1034afff6e2d1e406e7d9141b2a1,34873,465,35338,0
labeling,2025-02-28T15:33:30.976223,31e16caf2a6d45fb9cc41fb158b49933df4895f7,37607,515,38122,0
labeling,2025-02-28T15:34:20.988912,35839effbc332f23d5f34263aab3dcb2c6976420,100615,342,100957,0
labeling,2025-02-28T15:34:28.060594,35839effbc332f23d5f34263aab3dcb2c6976420,49629,354,49983,0
labeling,2025-02-28T15:35:05.733108,36dd058d3237202cbb94139611c8b8a35ff8c158,100610,290,100900,0
labeling,2025-02-28T15:35:12.046178,36dd058d3237202cbb94139611c8b8a35ff8c158,52483,226,52709,0
labeling,2025-02-28T15:35:30.937296,3bb894b4201667baf60b0b2c8a47109fa2357acb,32473,479,32952,0
labeling,2025-02-28T15:35:46.875673,3e5ccdb58faf901e75e31f154cb8330869ca5efa,35827,528,36355,0
labeling,2025-02-28T15:36:46.554219,3f36d4f26ada778d89cf5a7344be0b9e9a5223a3,100707,392,101099,0
labeling,2025-02-28T15:37:00.456314,3f36d4f26ada778d89cf5a7344be0b9e9a5223a3,84605,487,85092,0
labeling,2025-02-28T15:37:47.253338,446545ae548543d8744f8d885ff75face3424ba4,100662,90,100752,0
labeling,2025-02-28T15:37:51.728257,446545ae548543d8744f8d885ff75face3424ba4,32548,206,32754,0
labeling,2025-02-28T15:38:29.298027,4d3e52b69b4b5366e54ce87cf641b01b1419bdee,100549,782,101331,0
labeling,2025-02-28T15:38:36.763285,4d3e52b69b4b5366e54ce87cf641b01b1419bdee,25376,581,25957,0
labeling,2025-02-28T15:38:53.442377,4e3efdc544140b872a59e124443a64c34f356911,6818,433,7251,0
labeling,2025-02-28T15:39:42.944162,51bae8eeb78cf7d8d96c5cb66c36c41c6bd71491,100638,718,101356,0
labeling,2025-02-28T15:39:53.050621,51bae8eeb78cf7d8d96c5cb66c36c41c6bd71491,85955,344,86299,0
labeling,2025-02-28T15:40:04.276096,53a00624418f6c5c2d044344a4125bba7743614f,2367,86,2453,0
labeling,2025-02-28T15:40:13.829318,53aa4bfb3b29d7fc064e97626fc4f860942ca9fd,28849,432,29281,0
labeling,2025-02-28T15:40:44.380240,553afbf09b6d83166b17acb02431c6cf38e4defc,77546,452,77998,0
labeling,2025-02-28T15:41:35.067195,5a24fa827d172a7669eca206b2a5f47c2b19b48d,100042,409,100451,0
labeling,2025-02-28T15:41:43.157987,5a24fa827d172a7669eca206b2a5f47c2b19b48d,98873,108,98981,0
labeling,2025-02-28T15:43:58.590718,5bb5f71d1457f3272adab97d64a79c300da75cea,100755,795,101550,0
labeling,2025-02-28T15:44:17.374051,5bb5f71d1457f3272adab97d64a79c300da75cea,100387,736,101123,0
labeling,2025-02-28T15:44:33.032564,5bb5f71d1457f3272adab97d64a79c300da75cea,48698,805,49503,0
labeling,2025-02-28T15:45:07.837008,5f226fe96206888930e3baaf0bff70d4b0a1db40,100698,279,100977,0
labeling,2025-02-28T15:45:16.071839,5f226fe96206888930e3baaf0bff70d4b0a1db40,44299,488,44787,0
labeling,2025-02-28T15:46:11.217501,6159f86f38ec4f82453d99a01c22f1847de133c6,100434,658,101092,0
labeling,2025-02-28T15:46:21.533655,6159f86f38ec4f82453d99a01c22f1847de133c6,100168,234,100402,0
labeling,2025-02-28T15:46:24.978325,6159f86f38ec4f82453d99a01c22f1847de133c6,10603,156,10759,0
labeling,2025-02-28T15:46:46.368809,6406e378c1f49a29c836633f187c271b30b50183,49214,127,49341,0
labeling,2025-02-28T15:48:32.527254,6529fba868216a923407fb0d4e15a811a8e89ebc,99701,519,100220,0
labeling,2025-02-28T15:48:37.985707,6529fba868216a923407fb0d4e15a811a8e89ebc,9681,397,10078,0
labeling,2025-02-28T15:49:40.483687,67185fca2a09b3c46ee961b2c1ae160dab8b5231,99792,381,100173,0
labeling,2025-02-28T15:49:50.095577,67185fca2a09b3c46ee961b2c1ae160dab8b5231,38894,308,39202,0
labeling,2025-02-28T15:50:18.066377,674a255d82495ef40189645697460801193e5a2d,86001,588,86589,0
labeling,2025-02-28T15:51:10.407341,682de8e45fd9688f3452bc0e18257132a8f3cff6,99966,975,100941,0
labeling,2025-02-28T15:51:13.071213,682de8e45fd9688f3452bc0e18257132a8f3cff6,12212,89,12301,0
labeling,2025-02-28T15:53:22.424011,696ddc4c80febe0f1559ed3b1272487c74ca91cc,100311,152,100463,0
labeling,2025-02-28T15:53:32.295102,696ddc4c80febe0f1559ed3b1272487c74ca91cc,34359,714,35073,0
labeling,2025-02-28T15:54:18.259631,6d76ccb75bbf1b27ca60b8419c5343ac050cebb0,98750,474,99224,0
labeling,2025-02-28T15:54:23.351018,6d76ccb75bbf1b27ca60b8419c5343ac050cebb0,28930,211,29141,0
labeling,2025-02-28T15:54:54.381651,6e36d57320ec525da93b3ce2c7269580c746475b,100576,457,101033,0
labeling,2025-02-28T15:55:12.692208,6e36d57320ec525da93b3ce2c7269580c746475b,41789,513,42302,0
labeling,2025-02-28T15:55:42.735674,71d137454a1524843e1f49b34603438510232919,26573,1225,27798,0
labeling,2025-02-28T15:56:28.720312,74c690176ce433301f4d1e808bb002a2f4dc321a,100010,458,100468,0
labeling,2025-02-28T15:56:47.262382,74c690176ce433301f4d1e808bb002a2f4dc321a,68943,384,69327,0
labeling,2025-02-28T16:02:27.341836,7792e23f8a40fb9461dbc26f417b0fb948f54f46,20400,120,20520,0
labeling,2025-02-28T16:02:29.514344,7792e23f8a40fb9461dbc26f417b0fb948f54f46,20523,62,20585,0
labeling,2025-02-28T16:02:31.570193,7792e23f8a40fb9461dbc26f417b0fb948f54f46,20552,54,20606,0
labeling,2025-02-28T16:02:36.568223,7792e23f8a40fb9461dbc26f417b0fb948f54f46,20501,264,20765,0
labeling,2025-02-28T16:02:40.431684,7792e23f8a40fb9461dbc26f417b0fb948f54f46,20285,212,20497,0
labeling,2025-02-28T16:02:41.149238,7792e23f8a40fb9461dbc26f417b0fb948f54f46,5094,13,5107,0
labeling,2025-02-28T16:03:27.965122,78c71282723c2d66216cbba13183d19349d302b8,20261,550,20811,0
labeling,2025-02-28T16:03:39.713140,78c71282723c2d66216cbba13183d19349d302b8,20666,733,21399,0
labeling,2025-02-28T16:03:50.953224,78c71282723c2d66216cbba13183d19349d302b8,20570,524,21094,0
labeling,2025-02-28T16:03:55.162780,78c71282723c2d66216cbba13183d19349d302b8,20736,233,20969,0
labeling,2025-02-28T16:03:59.088139,78c71282723c2d66216cbba13183d19349d302b8,20266,182,20448,0
labeling,2025-02-28T16:04:00.789891,78c71282723c2d66216cbba13183d19349d302b8,11874,62,11936,0
labeling,2025-02-28T16:04:50.764358,79ffb9b8682aa565172233c070a47d944464644c,100294,564,100858,0
labeling,2025-02-28T16:04:55.651968,79ffb9b8682aa565172233c070a47d944464644c,47385,149,47534,0
labeling,2025-02-28T16:05:43.326942,7be0f16625505fb48ad135c1a3fccd75ce06671c,66366,997,67363,0
labeling,2025-02-28T16:06:59.637453,8467b7fce0d860b56e30c79d253d0bb5e9a32e95,100129,824,100953,0
labeling,2025-02-28T16:07:07.815900,8467b7fce0d860b56e30c79d253d0bb5e9a32e95,57424,204,57628,0
labeling,2025-02-28T16:07:58.352418,8f5e29eea4f4a3e944707c71148439ca1fd4b2d8,73320,718,74038,0
labeling,2025-02-28T16:08:33.119284,91ba1d46cdde9c1c0cf34f6bcc107741244f8f3d,97685,522,98207,0
labeling,2025-02-28T16:08:53.284283,91caa5884d3fbc344a05ac2f1d113a5d8725e4cb,62002,141,62143,0
labeling,2025-02-28T16:09:20.410167,92d9de8e4db96e0b95a484afcd1c54c6beb62c03,54040,627,54667,0
labeling,2025-02-28T16:13:20.686763,957f31e694198a1695d14aa512a972ab6f3c55b5,100547,525,101072,0
labeling,2025-02-28T16:13:30.027799,957f31e694198a1695d14aa512a972ab6f3c55b5,41322,146,41468,0
labeling,2025-02-28T16:14:03.680577,980742aa08ea64d552c153bcefbd7e8243fb9efd,100558,471,101029,0
labeling,2025-02-28T16:14:11.647730,980742aa08ea64d552c153bcefbd7e8243fb9efd,39257,344,39601,0
labeling,2025-02-28T16:15:41.363730,99cd0edaf5bfb233e5f46ee55af837de0b725274,20397,153,20550,0
labeling,2025-02-28T16:16:07.146296,99cd0edaf5bfb233e5f46ee55af837de0b725274,20555,562,21117,0
labeling,2025-02-28T16:16:09.156756,99cd0edaf5bfb233e5f46ee55af837de0b725274,20312,81,20393,0
labeling,2025-02-28T16:16:13.605138,99cd0edaf5bfb233e5f46ee55af837de0b725274,11310,247,11557,0
labeling,2025-02-28T16:16:44.019345,9af0a7f8db3954c3e74851c8c1807a09ece8ef00,20318,587,20905,0
labeling,2025-02-28T16:16:48.616516,9af0a7f8db3954c3e74851c8c1807a09ece8ef00,19769,200,19969,0
labeling,2025-02-28T16:17:02.934673,9af0a7f8db3954c3e74851c8c1807a09ece8ef00,20541,639,21180,0
labeling,2025-02-28T16:17:05.376283,9af0a7f8db3954c3e74851c8c1807a09ece8ef00,20401,100,20501,0
labeling,2025-02-28T16:17:13.725341,9af0a7f8db3954c3e74851c8c1807a09ece8ef00,20778,657,21435,0
labeling,2025-02-28T16:17:17.718002,9af0a7f8db3954c3e74851c8c1807a09ece8ef00,20791,184,20975,0
labeling,2025-02-28T16:17:23.249624,9af0a7f8db3954c3e74851c8c1807a09ece8ef00,12436,407,12843,0
labeling,2025-02-28T16:18:00.939078,9b7fdb871fc4d4a8babc25448257ae0b81a6442d,19979,507,20486,0
labeling,2025-02-28T16:18:05.659276,9b7fdb871fc4d4a8babc25448257ae0b81a6442d,20535,123,20658,0
labeling,2025-02-28T16:18:11.938355,9b7fdb871fc4d4a8babc25448257ae0b81a6442d,20614,462,21076,0
labeling,2025-02-28T16:18:17.508481,9b7fdb871fc4d4a8babc25448257ae0b81a6442d,19814,255,20069,0
labeling,2025-02-28T16:18:19.851784,9b7fdb871fc4d4a8babc25448257ae0b81a6442d,20101,116,20217,0
labeling,2025-02-28T16:18:28.254348,9b7fdb871fc4d4a8babc25448257ae0b81a6442d,20626,705,21331,0
labeling,2025-02-28T16:18:31.598630,9b7fdb871fc4d4a8babc25448257ae0b81a6442d,20152,91,20243,0
labeling,2025-02-28T16:18:34.057697,9b7fdb871fc4d4a8babc25448257ae0b81a6442d,20292,108,20400,0
labeling,2025-02-28T16:18:47.902104,9b7fdb871fc4d4a8babc25448257ae0b81a6442d,16051,303,16354,0
labeling,2025-02-28T16:19:47.004659,9e794a58e511f6a6a9a13b201d652deff9f9f69a,20408,428,20836,0
labeling,2025-02-28T16:19:49.397742,9e794a58e511f6a6a9a13b201d652deff9f9f69a,20741,93,20834,0
labeling,2025-02-28T16:20:01.392845,9e794a58e511f6a6a9a13b201d652deff9f9f69a,19930,643,20573,0
labeling,2025-02-28T16:20:09.521490,9e794a58e511f6a6a9a13b201d652deff9f9f69a,20371,617,20988,0
labeling,2025-02-28T16:20:38.622166,9e794a58e511f6a6a9a13b201d652deff9f9f69a,20326,505,20831,0
labeling,2025-02-28T16:20:43.563750,9e794a58e511f6a6a9a13b201d652deff9f9f69a,20780,212,20992,0
labeling,2025-02-28T16:20:56.691004,9e794a58e511f6a6a9a13b201d652deff9f9f69a,20455,889,21344,0
labeling,2025-02-28T16:21:09.478398,9e794a58e511f6a6a9a13b201d652deff9f9f69a,20715,416,21131,0
labeling,2025-02-28T16:21:12.481234,9e794a58e511f6a6a9a13b201d652deff9f9f69a,20166,136,20302,0
labeling,2025-02-28T16:21:14.968910,9e794a58e511f6a6a9a13b201d652deff9f9f69a,20555,122,20677,0
labeling,2025-02-28T16:21:24.491057,9e794a58e511f6a6a9a13b201d652deff9f9f69a,20389,722,21111,0
labeling,2025-02-28T16:21:26.637165,9e794a58e511f6a6a9a13b201d652deff9f9f69a,9382,87,9469,0
labeling,2025-02-28T16:21:42.074592,a533b44fe091a8aa62d1fa4f0a3262b311df8bd9,20716,253,20969,0
labeling,2025-02-28T16:21:49.579181,a533b44fe091a8aa62d1fa4f0a3262b311df8bd9,20588,319,20907,0
labeling,2025-02-28T16:21:53.613919,a533b44fe091a8aa62d1fa4f0a3262b311df8bd9,20458,303,20761,0
labeling,2025-02-28T16:22:03.606341,a533b44fe091a8aa62d1fa4f0a3262b311df8bd9,19526,827,20353,0
labeling,2025-02-28T16:22:04.988137,a533b44fe091a8aa62d1fa4f0a3262b311df8bd9,12491,33,12524,0
labeling,2025-02-28T16:22:31.372898,a69ebee82a9acd54117407ca3697db0d7bfbfdac,20582,772,21354,0
labeling,2025-02-28T16:22:36.666518,a69ebee82a9acd54117407ca3697db0d7bfbfdac,19938,378,20316,0
labeling,2025-02-28T16:22:40.077681,a69ebee82a9acd54117407ca3697db0d7bfbfdac,20384,168,20552,0
labeling,2025-02-28T16:22:49.689642,a69ebee82a9acd54117407ca3697db0d7bfbfdac,20233,305,20538,0
labeling,2025-02-28T16:22:52.482268,a69ebee82a9acd54117407ca3697db0d7bfbfdac,20633,142,20775,0
labeling,2025-02-28T16:23:00.472544,a69ebee82a9acd54117407ca3697db0d7bfbfdac,20788,520,21308,0
labeling,2025-02-28T16:23:06.586246,a69ebee82a9acd54117407ca3697db0d7bfbfdac,1866,193,2059,0
labeling,2025-02-28T16:23:18.669815,a85dba6c75031912d56a811637f803ba4ddeb257,20517,546,21063,0
labeling,2025-02-28T16:23:32.801751,a85dba6c75031912d56a811637f803ba4ddeb257,7890,760,8650,0
labeling,2025-02-28T16:24:16.325827,aa781901e117281bfee6f8e4bea6fc9c9bada62e,20685,1107,21792,0
labeling,2025-02-28T16:24:20.829907,aa781901e117281bfee6f8e4bea6fc9c9bada62e,19250,302,19552,0
labeling,2025-02-28T16:24:25.256597,aa781901e117281bfee6f8e4bea6fc9c9bada62e,20672,170,20842,0
labeling,2025-02-28T16:24:29.723567,aa781901e117281bfee6f8e4bea6fc9c9bada62e,18140,155,18295,0
labeling,2025-02-28T16:27:12.099697,ad1613dac24a1349ec293100e3ea19fe913bb930,20665,108,20773,0
labeling,2025-02-28T16:27:14.964355,ad1613dac24a1349ec293100e3ea19fe913bb930,20708,142,20850,0
labeling,2025-02-28T16:27:21.386163,ad1613dac24a1349ec293100e3ea19fe913bb930,20497,429,20926,0
labeling,2025-02-28T16:27:23.732154,ad1613dac24a1349ec293100e3ea19fe913bb930,17751,81,17832,0
labeling,2025-02-28T16:27:27.716777,ad1613dac24a1349ec293100e3ea19fe913bb930,19771,218,19989,0
labeling,2025-02-28T16:27:45.296982,b33bd2220c0fc0939ef08b1bdd8d2ebea158aa59,20188,374,20562,0
labeling,2025-02-28T16:27:49.264733,b33bd2220c0fc0939ef08b1bdd8d2ebea158aa59,20106,250,20356,0
labeling,2025-02-28T16:27:52.451530,b33bd2220c0fc0939ef08b1bdd8d2ebea158aa59,5790,154,5944,0
labeling,2025-02-28T16:28:22.693895,b3c406f0cd22d58b25d0f52852e1c4a5d73daf35,20287,578,20865,0
labeling,2025-02-28T16:28:39.973727,b3c406f0cd22d58b25d0f52852e1c4a5d73daf35,20542,474,21016,0
labeling,2025-02-28T16:28:48.937279,b3c406f0cd22d58b25d0f52852e1c4a5d73daf35,20247,539,20786,0
labeling,2025-02-28T16:28:51.201490,b3c406f0cd22d58b25d0f52852e1c4a5d73daf35,20664,96,20760,0
labeling,2025-02-28T16:28:53.313481,b3c406f0cd22d58b25d0f52852e1c4a5d73daf35,11746,123,11869,0
labeling,2025-02-28T16:29:31.339384,b947c33b370d8a3251ef9c36ce7d71e8d16f4f8e,20271,515,20786,0
labeling,2025-02-28T16:29:37.112167,b947c33b370d8a3251ef9c36ce7d71e8d16f4f8e,20613,382,20995,0
labeling,2025-02-28T16:29:39.787556,b947c33b370d8a3251ef9c36ce7d71e8d16f4f8e,19995,155,20150,0
labeling,2025-02-28T16:29:43.642771,b947c33b370d8a3251ef9c36ce7d71e8d16f4f8e,14819,219,15038,0
labeling,2025-02-28T16:30:04.904863,c06d5ad4b6408fec26675d30b37a6042c007095a,19962,287,20249,0
labeling,2025-02-28T16:30:15.433397,c06d5ad4b6408fec26675d30b37a6042c007095a,20540,309,20849,0
labeling,2025-02-28T16:30:16.931117,c06d5ad4b6408fec26675d30b37a6042c007095a,3529,95,3624,0
labeling,2025-02-28T16:31:10.115893,c5fc5890205fe5326d690fc017f7153fb09924e4,20040,564,20604,0
labeling,2025-02-28T16:31:15.242148,c5fc5890205fe5326d690fc017f7153fb09924e4,20675,314,20989,0
labeling,2025-02-28T16:31:21.698779,c5fc5890205fe5326d690fc017f7153fb09924e4,19457,501,19958,0
labeling,2025-02-28T16:31:29.228369,c5fc5890205fe5326d690fc017f7153fb09924e4,20595,578,21173,0
labeling,2025-02-28T16:31:37.161926,c5fc5890205fe5326d690fc017f7153fb09924e4,20043,499,20542,0
labeling,2025-02-28T16:31:44.637963,c5fc5890205fe5326d690fc017f7153fb09924e4,20653,524,21177,0
labeling,2025-02-28T16:31:51.795627,c5fc5890205fe5326d690fc017f7153fb09924e4,20577,584,21161,0
labeling,2025-02-28T16:31:56.547420,c5fc5890205fe5326d690fc017f7153fb09924e4,20467,347,20814,0
labeling,2025-02-28T16:32:03.513472,c5fc5890205fe5326d690fc017f7153fb09924e4,20541,406,20947,0
labeling,2025-02-28T16:32:41.213953,c5fc5890205fe5326d690fc017f7153fb09924e4,13717,608,14325,0
labeling,2025-02-28T16:36:26.157079,c74139ce26a6f803725f5074a8a0f539abb99c09,20323,207,20530,0
labeling,2025-02-28T16:36:29.365554,c74139ce26a6f803725f5074a8a0f539abb99c09,20317,178,20495,0
labeling,2025-02-28T16:36:32.707628,c74139ce26a6f803725f5074a8a0f539abb99c09,20361,182,20543,0
labeling,2025-02-28T16:36:36.574855,c74139ce26a6f803725f5074a8a0f539abb99c09,20679,101,20780,0
labeling,2025-02-28T16:36:41.599404,c74139ce26a6f803725f5074a8a0f539abb99c09,20370,154,20524,0
labeling,2025-02-28T16:36:44.987491,c74139ce26a6f803725f5074a8a0f539abb99c09,20523,175,20698,0
labeling,2025-02-28T16:36:50.462213,c74139ce26a6f803725f5074a8a0f539abb99c09,20202,417,20619,0
labeling,2025-02-28T16:37:06.982319,c74139ce26a6f803725f5074a8a0f539abb99c09,19972,742,20714,0
labeling,2025-02-28T16:37:09.607574,c74139ce26a6f803725f5074a8a0f539abb99c09,20512,110,20622,0
labeling,2025-02-28T16:37:12.902107,c74139ce26a6f803725f5074a8a0f539abb99c09,20168,222,20390,0
labeling,2025-02-28T16:37:18.566370,c74139ce26a6f803725f5074a8a0f539abb99c09,20642,280,20922,0
labeling,2025-02-28T16:37:21.199266,c74139ce26a6f803725f5074a8a0f539abb99c09,20694,156,20850,0
labeling,2025-02-28T16:37:24.387928,c74139ce26a6f803725f5074a8a0f539abb99c09,20437,130,20567,0
labeling,2025-02-28T16:37:27.793445,c74139ce26a6f803725f5074a8a0f539abb99c09,20835,94,20929,0
labeling,2025-02-28T16:37:36.590678,c74139ce26a6f803725f5074a8a0f539abb99c09,20316,401,20717,0
labeling,2025-02-28T16:37:39.897830,c74139ce26a6f803725f5074a8a0f539abb99c09,20157,147,20304,0
labeling,2025-02-28T16:37:44.561846,c74139ce26a6f803725f5074a8a0f539abb99c09,20363,265,20628,0
labeling,2025-02-28T16:38:03.781770,c74139ce26a6f803725f5074a8a0f539abb99c09,20538,846,21384,0
labeling,2025-02-28T16:38:06.440748,c74139ce26a6f803725f5074a8a0f539abb99c09,20815,113,20928,0
labeling,2025-02-28T16:38:11.881975,c74139ce26a6f803725f5074a8a0f539abb99c09,20294,167,20461,0
labeling,2025-02-28T16:38:18.475685,c74139ce26a6f803725f5074a8a0f539abb99c09,20553,486,21039,0
labeling,2025-02-28T16:38:21.133280,c74139ce26a6f803725f5074a8a0f539abb99c09,20605,138,20743,0
labeling,2025-02-28T16:38:23.590058,c74139ce26a6f803725f5074a8a0f539abb99c09,20774,95,20869,0
labeling,2025-02-28T16:38:26.050566,c74139ce26a6f803725f5074a8a0f539abb99c09,19827,87,19914,0
labeling,2025-02-28T16:38:34.752988,c74139ce26a6f803725f5074a8a0f539abb99c09,20494,745,21239,0
labeling,2025-02-28T16:38:45.497743,c74139ce26a6f803725f5074a8a0f539abb99c09,20449,742,21191,0
labeling,2025-02-28T16:38:49.789296,c74139ce26a6f803725f5074a8a0f539abb99c09,20017,204,20221,0
labeling,2025-02-28T16:38:52.101819,c74139ce26a6f803725f5074a8a0f539abb99c09,20548,104,20652,0
labeling,2025-02-28T16:38:56.840620,c74139ce26a6f803725f5074a8a0f539abb99c09,20849,150,20999,0
labeling,2025-02-28T16:39:00.393174,c74139ce26a6f803725f5074a8a0f539abb99c09,20628,215,20843,0
labeling,2025-02-28T16:39:04.646627,c74139ce26a6f803725f5074a8a0f539abb99c09,20822,254,21076,0
labeling,2025-02-28T16:39:09.161949,c74139ce26a6f803725f5074a8a0f539abb99c09,13152,220,13372,0
labeling,2025-02-28T16:39:46.129220,c7475e1d98f9a46a4652e503881d4a67232b41d3,20738,914,21652,0
labeling,2025-02-28T16:39:51.448510,c7475e1d98f9a46a4652e503881d4a67232b41d3,20540,292,20832,0
labeling,2025-02-28T16:39:54.472315,c7475e1d98f9a46a4652e503881d4a67232b41d3,13978,168,14146,0
labeling,2025-02-28T16:40:19.511953,c8af22dbedd95ee719273792e5964ab8bbba17b2,20577,945,21522,0
labeling,2025-02-28T16:40:27.486636,c8af22dbedd95ee719273792e5964ab8bbba17b2,20102,512,20614,0
labeling,2025-02-28T16:40:31.896399,c8af22dbedd95ee719273792e5964ab8bbba17b2,16114,338,16452,0
labeling,2025-02-28T16:41:14.116209,cc0fc5888b99758100a7ff024863fc4337b6b3c5,20515,449,20964,0
labeling,2025-02-28T16:41:32.527479,cc0fc5888b99758100a7ff024863fc4337b6b3c5,20289,1310,21599,0
labeling,2025-02-28T16:41:40.352638,cc0fc5888b99758100a7ff024863fc4337b6b3c5,20487,359,20846,0
labeling,2025-02-28T16:41:42.676688,cc0fc5888b99758100a7ff024863fc4337b6b3c5,20368,106,20474,0
labeling,2025-02-28T16:41:47.671601,cc0fc5888b99758100a7ff024863fc4337b6b3c5,20614,254,20868,0
labeling,2025-02-28T16:41:53.064205,cc0fc5888b99758100a7ff024863fc4337b6b3c5,20829,399,21228,0
labeling,2025-02-28T16:41:55.283742,cc0fc5888b99758100a7ff024863fc4337b6b3c5,20520,120,20640,0
labeling,2025-02-28T16:42:04.440728,cc0fc5888b99758100a7ff024863fc4337b6b3c5,20163,450,20613,0
labeling,2025-02-28T16:42:09.505400,cc0fc5888b99758100a7ff024863fc4337b6b3c5,20367,249,20616,0
labeling,2025-02-28T16:42:16.957867,cc0fc5888b99758100a7ff024863fc4337b6b3c5,20355,562,20917,0
labeling,2025-02-28T16:42:20.946462,cc0fc5888b99758100a7ff024863fc4337b6b3c5,20214,173,20387,0
labeling,2025-02-28T16:42:25.045777,cc0fc5888b99758100a7ff024863fc4337b6b3c5,20301,265,20566,0
labeling,2025-02-28T16:42:41.296837,d14ae2b6284e48b5c1e6659a0a5863d84697b3b9,20192,304,20496,0
labeling,2025-02-28T16:42:44.401267,d14ae2b6284e48b5c1e6659a0a5863d84697b3b9,20649,199,20848,0
labeling,2025-02-28T16:42:46.996688,d14ae2b6284e48b5c1e6659a0a5863d84697b3b9,10220,180,10400,0
labeling,2025-02-28T16:43:30.858935,d5ad1d288230072e3f6654bb6182d76f8af2ba0a,20064,919,20983,0
labeling,2025-02-28T16:45:27.856857,d5ad1d288230072e3f6654bb6182d76f8af2ba0a,20332,584,20916,0
labeling,2025-02-28T16:45:29.872866,d5ad1d288230072e3f6654bb6182d76f8af2ba0a,20352,88,20440,0
labeling,2025-02-28T16:45:30.962076,d5ad1d288230072e3f6654bb6182d76f8af2ba0a,2582,30,2612,0
labeling,2025-02-28T16:45:53.431227,d86be8a2fa1aab721d7de6de7fd4f5267c914cb2,20159,447,20606,0
labeling,2025-02-28T16:46:05.288355,d86be8a2fa1aab721d7de6de7fd4f5267c914cb2,20246,812,21058,0
labeling,2025-02-28T16:46:09.913095,d86be8a2fa1aab721d7de6de7fd4f5267c914cb2,20674,209,20883,0
labeling,2025-02-28T16:46:12.402195,d86be8a2fa1aab721d7de6de7fd4f5267c914cb2,10773,133,10906,0
labeling,2025-02-28T16:46:53.434895,da663e46fbf02ec8a90b3f3c1079ef4c9f7907e1,20735,928,21663,0
labeling,2025-02-28T16:46:57.417885,da663e46fbf02ec8a90b3f3c1079ef4c9f7907e1,20325,297,20622,0
labeling,2025-02-28T16:47:06.690128,da663e46fbf02ec8a90b3f3c1079ef4c9f7907e1,20796,680,21476,0
labeling,2025-02-28T16:47:15.661489,da663e46fbf02ec8a90b3f3c1079ef4c9f7907e1,20677,576,21253,0
labeling,2025-02-28T16:47:20.072701,da663e46fbf02ec8a90b3f3c1079ef4c9f7907e1,9971,236,10207,0
labeling,2025-02-28T16:47:33.653050,ddd10e4612006205c4b1ba050a11648071e6e429,20435,168,20603,0
labeling,2025-02-28T16:47:36.561734,ddd10e4612006205c4b1ba050a11648071e6e429,18845,148,18993,0
labeling,2025-02-28T16:48:53.351875,ded965ce7e3ea0ad9b83272b8c36f529793a2887,20645,602,21247,0
labeling,2025-02-28T16:49:26.146061,ded965ce7e3ea0ad9b83272b8c36f529793a2887,20079,79,20158,0
labeling,2025-02-28T16:49:32.263510,ded965ce7e3ea0ad9b83272b8c36f529793a2887,20017,400,20417,0
labeling,2025-02-28T16:49:38.917282,ded965ce7e3ea0ad9b83272b8c36f529793a2887,19694,592,20286,0
labeling,2025-02-28T16:49:49.295464,ded965ce7e3ea0ad9b83272b8c36f529793a2887,20298,684,20982,0
labeling,2025-02-28T16:49:52.452103,ded965ce7e3ea0ad9b83272b8c36f529793a2887,20135,158,20293,0
labeling,2025-02-28T16:50:02.180454,ded965ce7e3ea0ad9b83272b8c36f529793a2887,19974,573,20547,0
labeling,2025-02-28T16:50:04.621042,ded965ce7e3ea0ad9b83272b8c36f529793a2887,20786,120,20906,0
labeling,2025-02-28T16:50:07.698602,ded965ce7e3ea0ad9b83272b8c36f529793a2887,20644,120,20764,0
labeling,2025-02-28T16:50:18.249718,ded965ce7e3ea0ad9b83272b8c36f529793a2887,12052,624,12676,0
labeling,2025-02-28T16:51:07.911632,e117005fc313bf0d49429d34bc8e1ef64de54898,20701,79,20780,0
labeling,2025-02-28T16:51:10.362280,e117005fc313bf0d49429d34bc8e1ef64de54898,20259,109,20368,0
labeling,2025-02-28T16:51:16.306321,e117005fc313bf0d49429d34bc8e1ef64de54898,20419,397,20816,0
labeling,2025-02-28T16:51:18.668303,e117005fc313bf0d49429d34bc8e1ef64de54898,19175,133,19308,0
labeling,2025-02-28T16:51:24.700678,e117005fc313bf0d49429d34bc8e1ef64de54898,9889,395,10284,0
labeling,2025-02-28T16:51:49.033185,e1edf72618e9d6ae2e72bb3ac7a9ddc15240e4ef,20295,302,20597,0
labeling,2025-02-28T16:51:52.444869,e1edf72618e9d6ae2e72bb3ac7a9ddc15240e4ef,20038,128,20166,0
labeling,2025-02-28T16:51:55.013330,e1edf72618e9d6ae2e72bb3ac7a9ddc15240e4ef,20607,101,20708,0
labeling,2025-02-28T16:51:58.732602,e1edf72618e9d6ae2e72bb3ac7a9ddc15240e4ef,20206,210,20416,0
labeling,2025-02-28T16:52:01.055606,e1edf72618e9d6ae2e72bb3ac7a9ddc15240e4ef,16771,100,16871,0
labeling,2025-02-28T16:52:41.921609,e21ac6c083a56192fab027ebd2ab0fad71de5d7d,20697,963,21660,0
labeling,2025-02-28T16:52:48.458101,e21ac6c083a56192fab027ebd2ab0fad71de5d7d,20515,505,21020,0
labeling,2025-02-28T16:52:51.059385,e21ac6c083a56192fab027ebd2ab0fad71de5d7d,20198,117,20315,0
labeling,2025-02-28T16:53:02.854942,e21ac6c083a56192fab027ebd2ab0fad71de5d7d,20797,778,21575,0
labeling,2025-02-28T16:53:08.191678,e21ac6c083a56192fab027ebd2ab0fad71de5d7d,20748,364,21112,0
labeling,2025-02-28T16:53:15.297047,e21ac6c083a56192fab027ebd2ab0fad71de5d7d,10836,526,11362,0
labeling,2025-02-28T16:53:44.599942,e229fc9f5c694e93b02ac312c231607a04e3e528,19967,556,20523,0
labeling,2025-02-28T16:53:49.463147,e229fc9f5c694e93b02ac312c231607a04e3e528,19726,325,20051,0
labeling,2025-02-28T16:53:52.323316,e229fc9f5c694e93b02ac312c231607a04e3e528,19846,115,19961,0
labeling,2025-02-28T16:53:56.243601,e229fc9f5c694e93b02ac312c231607a04e3e528,20290,258,20548,0
labeling,2025-02-28T16:53:57.961249,e229fc9f5c694e93b02ac312c231607a04e3e528,11999,98,12097,0
labeling,2025-02-28T16:54:43.252710,e273ed0d9626b9feaf50c09405c2b70d461e41d7,59218,432,59650,0
labeling,2025-02-28T16:54:59.139970,e2850fff8d9dee77f3a6520d0b1aba46adddc2c0,24262,601,24863,0
labeling,2025-02-28T16:55:25.675685,e2923f240db86d0096f462f6cb398339d3251b50,88483,170,88653,0
labeling,2025-02-28T16:55:59.237102,e30ece688caf7602b734bbbcf39559b4acdb2739,100381,621,101002,0
labeling,2025-02-28T16:56:11.467125,e30ece688caf7602b734bbbcf39559b4acdb2739,11691,558,12249,0
labeling,2025-02-28T16:57:49.827815,e6ce8ed579e95d2cfeabbbed872beb0c3f8396d7,100619,790,101409,0
labeling,2025-02-28T16:58:02.921018,e6ce8ed579e95d2cfeabbbed872beb0c3f8396d7,23569,657,24226,0
labeling,2025-02-28T16:58:50.370955,e7a45fed0d7ebfd13a524e7fcc443318bac654e2,100110,380,100490,0
labeling,2025-02-28T16:58:56.160394,e7a45fed0d7ebfd13a524e7fcc443318bac654e2,28393,350,28743,0
labeling,2025-02-28T16:59:26.395964,e7f655f43bc2abf6216519187d9fc907e9224937,100169,220,100389,0
labeling,2025-02-28T16:59:32.124960,e7f655f43bc2abf6216519187d9fc907e9224937,20605,310,20915,0
labeling,2025-02-28T17:00:20.455892,ecabab4934d4b80570c4bb3b8e35b7476694b3fb,100376,735,101111,0
labeling,2025-02-28T17:00:26.299723,ecabab4934d4b80570c4bb3b8e35b7476694b3fb,24254,301,24555,0
labeling,2025-02-28T17:00:43.676445,f015d4bfeec43fe65c003b6f4420ae864efbb58f,44163,636,44799,0
filter_labels,2025-02-28T17:00:51.228720,ecabab4934d4b80570c4bb3b8e35b7476694b3fb,1530,55,1585,0
answer_question,2025-02-28T17:00:55.310246,ecabab4934d4b80570c4bb3b8e35b7476694b3fb,2380,82,2462,0
filter_labels,2025-02-28T17:00:58.864050,446545ae548543d8744f8d885ff75face3424ba4,631,124,755,0
answer_question,2025-02-28T17:01:00.703597,446545ae548543d8744f8d885ff75face3424ba4,691,32,723,0
labeling,2025-02-28T17:01:02.862681,f6a1077a46cb36761604f8f4840698e22837f5f7,31890,337,32227,0
filter_labels,2025-02-28T17:01:03.641459,9e794a58e511f6a6a9a13b201d652deff9f9f69a,6292,79,6371,0
answer_question,2025-02-28T17:01:07.987009,9e794a58e511f6a6a9a13b201d652deff9f9f69a,5589,77,5666,0
filter_labels,2025-02-28T17:01:10.221751,92d9de8e4db96e0b95a484afcd1c54c6beb62c03,1056,67,1123,0
answer_question,2025-02-28T17:01:13.635161,92d9de8e4db96e0b95a484afcd1c54c6beb62c03,1174,89,1263,0
filter_labels,2025-02-28T17:01:20.262180,ddd10e4612006205c4b1ba050a11648071e6e429,665,175,840,0
answer_question,2025-02-28T17:01:26.933342,ddd10e4612006205c4b1ba050a11648071e6e429,16674,73,16747,2816
filter_labels,2025-02-28T17:01:29.851386,682de8e45fd9688f3452bc0e18257132a8f3cff6,1595,85,1680,0
answer_question,2025-02-28T17:01:33.745456,682de8e45fd9688f3452bc0e18257132a8f3cff6,3115,90,3205,0
filter_labels,2025-02-28T17:01:37.664955,c74139ce26a6f803725f5074a8a0f539abb99c09,10669,101,10770,0
labeling,2025-02-28T17:02:00.288746,f7324f3868005b3aae6aafd30441c9bb6c8823e8,100185,380,100565,0
answer_question,2025-02-28T17:02:01.231991,c74139ce26a6f803725f5074a8a0f539abb99c09,8688,67,8755,0
filter_labels,2025-02-28T17:02:04.253812,e117005fc313bf0d49429d34bc8e1ef64de54898,1428,72,1500,0
labeling,2025-02-28T17:02:09.320727,f7324f3868005b3aae6aafd30441c9bb6c8823e8,93656,206,93862,0
answer_question,2025-02-28T17:02:18.772555,e117005fc313bf0d49429d34bc8e1ef64de54898,3789,34,3823,0
filter_labels,2025-02-28T17:02:22.520830,553afbf09b6d83166b17acb02431c6cf38e4defc,842,91,933,0
answer_question,2025-02-28T17:02:26.672453,553afbf09b6d83166b17acb02431c6cf38e4defc,2348,95,2443,0
filter_labels,2025-02-28T17:02:51.564410,1af8f906e34af6e0acfe4f73e37093bbe34700f3,1626,832,2458,0
labeling,2025-02-28T17:03:06.052238,f85f0ccbbc59f1423d52d44e5ab70e3a01164499,100102,218,100320,0
labeling,2025-02-28T17:03:10.887785,f85f0ccbbc59f1423d52d44e5ab70e3a01164499,51592,124,51716,0
labeling,2025-02-28T17:03:48.831647,f879b3a802ccd6e8e6ca0a07ed8464318b7c0724,37311,1718,39029,0
labeling,2025-02-28T17:04:31.037858,f9736aa2f56c40b127bced09ce1c8e8cbf7aa0e3,100483,215,100698,0
labeling,2025-02-28T17:04:33.590904,f9736aa2f56c40b127bced09ce1c8e8cbf7aa0e3,16711,116,16827,0
filter_labels,2025-02-28T17:05:47.320158,ecabab4934d4b80570c4bb3b8e35b7476694b3fb,1530,78,1608,1408
answer_question,2025-02-28T17:05:51.275268,ecabab4934d4b80570c4bb3b8e35b7476694b3fb,2314,82,2396,0
filter_labels,2025-02-28T17:05:56.367438,446545ae548543d8744f8d885ff75face3424ba4,631,160,791,0
answer_question,2025-02-28T17:06:01.928309,446545ae548543d8744f8d885ff75face3424ba4,13514,62,13576,0
filter_labels,2025-02-28T17:06:03.406783,9e794a58e511f6a6a9a13b201d652deff9f9f69a,6292,37,6329,6272
answer_question,2025-02-28T17:06:08.078312,9e794a58e511f6a6a9a13b201d652deff9f9f69a,5503,89,5592,0
filter_labels,2025-02-28T17:06:10.698822,92d9de8e4db96e0b95a484afcd1c54c6beb62c03,1056,65,1121,1024
answer_question,2025-02-28T17:06:13.323030,92d9de8e4db96e0b95a484afcd1c54c6beb62c03,1094,71,1165,0
filter_labels,2025-02-28T17:06:16.605829,ddd10e4612006205c4b1ba050a11648071e6e429,665,140,805,0
answer_question,2025-02-28T17:06:19.752306,ddd10e4612006205c4b1ba050a11648071e6e429,3364,65,3429,0
filter_labels,2025-02-28T17:06:21.659920,682de8e45fd9688f3452bc0e18257132a8f3cff6,1595,70,1665,1536
answer_question,2025-02-28T17:06:24.963920,682de8e45fd9688f3452bc0e18257132a8f3cff6,3019,89,3108,0
filter_labels,2025-02-28T17:06:32.112990,c74139ce26a6f803725f5074a8a0f539abb99c09,10669,96,10765,10624
answer_question,2025-02-28T17:06:52.047898,c74139ce26a6f803725f5074a8a0f539abb99c09,8598,67,8665,0
filter_labels,2025-02-28T17:06:56.096989,e117005fc313bf0d49429d34bc8e1ef64de54898,1428,152,1580,1408
answer_question,2025-02-28T17:07:22.801113,e117005fc313bf0d49429d34bc8e1ef64de54898,9314,66,9380,0
filter_labels,2025-02-28T17:07:25.751942,553afbf09b6d83166b17acb02431c6cf38e4defc,842,126,968,0
answer_question,2025-02-28T17:07:29.577062,553afbf09b6d83166b17acb02431c6cf38e4defc,2246,95,2341,0
filter_labels,2025-02-28T17:07:32.496016,1af8f906e34af6e0acfe4f73e37093bbe34700f3,1626,132,1758,1536
answer_question,2025-02-28T17:07:40.132788,1af8f906e34af6e0acfe4f73e37093bbe34700f3,8393,69,8462,0
filter_labels,2025-02-28T17:07:43.317501,e30ece688caf7602b734bbbcf39559b4acdb2739,1734,105,1839,0
answer_question,2025-02-28T17:07:52.101615,e30ece688caf7602b734bbbcf39559b4acdb2739,4920,98,5018,0
filter_labels,2025-02-28T17:07:57.321704,0a61a353b1ea9fd9b8f63b60239634ca3007d58f,2244,76,2320,0
answer_question,2025-02-28T17:08:03.816488,0a61a353b1ea9fd9b8f63b60239634ca3007d58f,2705,70,2775,0
filter_labels,2025-02-28T17:08:06.325945,a85dba6c75031912d56a811637f803ba4ddeb257,1925,103,2028,0
answer_question,2025-02-28T17:08:10.214613,a85dba6c75031912d56a811637f803ba4ddeb257,2284,92,2376,0
filter_labels,2025-02-28T17:08:15.155023,aa781901e117281bfee6f8e4bea6fc9c9bada62e,2350,63,2413,0
answer_question,2025-02-28T17:08:21.520079,aa781901e117281bfee6f8e4bea6fc9c9bada62e,2881,64,2945,0
filter_labels,2025-02-28T17:08:56.894419,ecabab4934d4b80570c4bb3b8e35b7476694b3fb,1530,72,1602,1408
answer_question,2025-02-28T17:09:01.434636,ecabab4934d4b80570c4bb3b8e35b7476694b3fb,2314,82,2396,2304
filter_labels,2025-02-28T17:09:17.629350,446545ae548543d8744f8d885ff75face3424ba4,631,524,1155,0
filter_labels,2025-02-28T17:10:05.346139,ecabab4934d4b80570c4bb3b8e35b7476694b3fb,1530,53,1583,1408
answer_question,2025-02-28T17:10:09.165511,ecabab4934d4b80570c4bb3b8e35b7476694b3fb,2314,82,2396,2304
filter_labels,2025-02-28T17:10:14.315317,446545ae548543d8744f8d885ff75face3424ba4,631,195,826,0
answer_question,2025-02-28T17:10:27.833717,446545ae548543d8744f8d885ff75face3424ba4,29520,62,29582,0
filter_labels,2025-02-28T17:10:34.004987,9e794a58e511f6a6a9a13b201d652deff9f9f69a,6292,69,6361,6272
answer_question,2025-02-28T17:10:47.803980,9e794a58e511f6a6a9a13b201d652deff9f9f69a,5503,78,5581,5376
filter_labels,2025-02-28T17:10:50.201948,92d9de8e4db96e0b95a484afcd1c54c6beb62c03,1056,63,1119,1024
answer_question,2025-02-28T17:10:55.100416,92d9de8e4db96e0b95a484afcd1c54c6beb62c03,1094,71,1165,1024
filter_labels,2025-02-28T17:11:01.886657,ddd10e4612006205c4b1ba050a11648071e6e429,665,220,885,0
answer_question,2025-02-28T17:11:08.102884,ddd10e4612006205c4b1ba050a11648071e6e429,7504,73,7577,0
filter_labels,2025-02-28T17:11:10.227244,682de8e45fd9688f3452bc0e18257132a8f3cff6,1585,83,1668,0
answer_question,2025-02-28T17:11:17.644769,682de8e45fd9688f3452bc0e18257132a8f3cff6,3009,89,3098,0
filter_labels,2025-02-28T17:16:45.778172,ecabab4934d4b80570c4bb3b8e35b7476694b3fb,1530,83,1613,1408
answer_question,2025-02-28T17:16:49.417699,ecabab4934d4b80570c4bb3b8e35b7476694b3fb,2331,82,2413,0
filter_labels,2025-02-28T17:16:57.393443,446545ae548543d8744f8d885ff75face3424ba4,631,259,890,0
answer_question,2025-02-28T17:17:11.525131,446545ae548543d8744f8d885ff75face3424ba4,28805,70,28875,0
filter_labels,2025-02-28T17:17:17.363445,9e794a58e511f6a6a9a13b201d652deff9f9f69a,6292,74,6366,6272
answer_question,2025-02-28T17:17:32.348980,9e794a58e511f6a6a9a13b201d652deff9f9f69a,5520,78,5598,0
filter_labels,2025-02-28T17:17:35.641037,92d9de8e4db96e0b95a484afcd1c54c6beb62c03,1056,76,1132,0
answer_question,2025-02-28T17:17:38.213183,92d9de8e4db96e0b95a484afcd1c54c6beb62c03,1111,71,1182,0
filter_labels,2025-02-28T17:17:41.859227,ddd10e4612006205c4b1ba050a11648071e6e429,665,185,850,0
answer_question,2025-02-28T17:18:25.065206,ddd10e4612006205c4b1ba050a11648071e6e429,21759,73,21832,0
filter_labels,2025-02-28T17:18:29.250926,682de8e45fd9688f3452bc0e18257132a8f3cff6,1595,72,1667,1536
answer_question,2025-02-28T17:18:33.248467,682de8e45fd9688f3452bc0e18257132a8f3cff6,3036,89,3125,0
filter_labels,2025-02-28T17:18:47.949721,c74139ce26a6f803725f5074a8a0f539abb99c09,10669,93,10762,10624
answer_question,2025-02-28T17:19:07.069895,c74139ce26a6f803725f5074a8a0f539abb99c09,8615,75,8690,0
filter_labels,2025-02-28T17:19:10.138033,e117005fc313bf0d49429d34bc8e1ef64de54898,1428,77,1505,1408
answer_question,2025-02-28T17:19:26.225683,e117005fc313bf0d49429d34bc8e1ef64de54898,3710,66,3776,0
filter_labels,2025-02-28T17:19:29.708892,553afbf09b6d83166b17acb02431c6cf38e4defc,842,100,942,0
answer_question,2025-02-28T17:19:33.729377,553afbf09b6d83166b17acb02431c6cf38e4defc,2263,95,2358,0
filter_labels,2025-02-28T17:19:36.112411,1af8f906e34af6e0acfe4f73e37093bbe34700f3,1626,81,1707,1536
answer_question,2025-02-28T17:19:37.623811,1af8f906e34af6e0acfe4f73e37093bbe34700f3,577,34,611,0
filter_labels,2025-02-28T17:19:40.446390,e30ece688caf7602b734bbbcf39559b4acdb2739,1734,104,1838,1664
answer_question,2025-02-28T17:19:46.836437,e30ece688caf7602b734bbbcf39559b4acdb2739,4937,92,5029,0
filter_labels,2025-02-28T17:19:48.818530,0a61a353b1ea9fd9b8f63b60239634ca3007d58f,2244,81,2325,2176
answer_question,2025-02-28T17:19:52.620680,0a61a353b1ea9fd9b8f63b60239634ca3007d58f,3450,70,3520,0
filter_labels,2025-02-28T17:19:55.694774,a85dba6c75031912d56a811637f803ba4ddeb257,1925,107,2032,1920
answer_question,2025-02-28T17:19:59.913034,a85dba6c75031912d56a811637f803ba4ddeb257,3084,92,3176,0
filter_labels,2025-02-28T17:20:05.416248,aa781901e117281bfee6f8e4bea6fc9c9bada62e,2350,69,2419,2304
answer_question,2025-02-28T17:20:12.364513,aa781901e117281bfee6f8e4bea6fc9c9bada62e,2898,64,2962,0
filter_labels,2025-02-28T17:20:15.927268,e30ece688caf7602b734bbbcf39559b4acdb2739,1716,105,1821,1664
answer_question,2025-02-28T17:20:17.702691,e30ece688caf7602b734bbbcf39559b4acdb2739,571,33,604,0
filter_labels,2025-02-28T17:20:20.610053,36dd058d3237202cbb94139611c8b8a35ff8c158,878,108,986,0
answer_question,2025-02-28T17:20:26.954818,36dd058d3237202cbb94139611c8b8a35ff8c158,3324,83,3407,0
filter_labels,2025-02-28T17:20:31.652200,5a24fa827d172a7669eca206b2a5f47c2b19b48d,903,76,979,0
answer_question,2025-02-28T17:20:38.019374,5a24fa827d172a7669eca206b2a5f47c2b19b48d,4148,80,4228,0
filter_labels,2025-02-28T18:48:44.736460,ecabab4934d4b80570c4bb3b8e35b7476694b3fb,1530,50,1580,0
answer_question,2025-02-28T18:48:47.022155,ecabab4934d4b80570c4bb3b8e35b7476694b3fb,2331,47,2378,0
filter_labels,2025-02-28T18:48:48.025908,446545ae548543d8744f8d885ff75face3424ba4,631,53,684,0
answer_question,2025-02-28T18:48:51.009776,446545ae548543d8744f8d885ff75face3424ba4,5852,62,5914,0
filter_labels,2025-02-28T18:48:52.601407,9e794a58e511f6a6a9a13b201d652deff9f9f69a,6292,65,6357,0
answer_question,2025-02-28T18:48:54.900927,9e794a58e511f6a6a9a13b201d652deff9f9f69a,5520,40,5560,0
filter_labels,2025-02-28T18:48:56.355424,92d9de8e4db96e0b95a484afcd1c54c6beb62c03,1056,59,1115,0
answer_question,2025-02-28T18:48:58.163337,92d9de8e4db96e0b95a484afcd1c54c6beb62c03,1111,34,1145,0
filter_labels,2025-02-28T18:48:59.408942,ddd10e4612006205c4b1ba050a11648071e6e429,665,59,724,0
answer_question,2025-02-28T18:49:01.250513,ddd10e4612006205c4b1ba050a11648071e6e429,766,33,799,0
filter_labels,2025-02-28T18:49:02.693801,682de8e45fd9688f3452bc0e18257132a8f3cff6,1595,66,1661,0
answer_question,2025-02-28T18:49:07.199897,682de8e45fd9688f3452bc0e18257132a8f3cff6,3036,89,3125,0
filter_labels,2025-02-28T18:49:09.596210,c74139ce26a6f803725f5074a8a0f539abb99c09,10669,56,10725,0
answer_question,2025-02-28T18:49:14.982537,c74139ce26a6f803725f5074a8a0f539abb99c09,3317,33,3350,0
filter_labels,2025-02-28T18:49:16.400823,e117005fc313bf0d49429d34bc8e1ef64de54898,1428,48,1476,0
answer_question,2025-02-28T18:49:19.530595,e117005fc313bf0d49429d34bc8e1ef64de54898,3710,34,3744,0
filter_labels,2025-02-28T18:49:20.809535,553afbf09b6d83166b17acb02431c6cf38e4defc,842,79,921,0
answer_question,2025-02-28T18:49:23.170645,553afbf09b6d83166b17acb02431c6cf38e4defc,2263,50,2313,0
filter_labels,2025-02-28T18:49:25.960756,1af8f906e34af6e0acfe4f73e37093bbe34700f3,1626,140,1766,0
answer_question,2025-02-28T18:49:28.284297,1af8f906e34af6e0acfe4f73e37093bbe34700f3,5866,69,5935,0
filter_labels,2025-02-28T18:49:29.776771,e30ece688caf7602b734bbbcf39559b4acdb2739,1734,81,1815,0
answer_question,2025-02-28T18:49:31.764513,e30ece688caf7602b734bbbcf39559b4acdb2739,4937,50,4987,0
filter_labels,2025-02-28T18:49:33.042689,0a61a353b1ea9fd9b8f63b60239634ca3007d58f,2244,57,2301,0
answer_question,2025-02-28T18:49:35.756468,0a61a353b1ea9fd9b8f63b60239634ca3007d58f,4331,70,4401,0
filter_labels,2025-02-28T18:49:37.863603,a85dba6c75031912d56a811637f803ba4ddeb257,1925,135,2060,0
filter_labels,2025-02-28T18:51:22.838447,ecabab4934d4b80570c4bb3b8e35b7476694b3fb,1530,58,1588,1408
answer_question,2025-02-28T18:51:25.311762,ecabab4934d4b80570c4bb3b8e35b7476694b3fb,2331,47,2378,2304
filter_labels,2025-02-28T18:51:26.807351,446545ae548543d8744f8d885ff75face3424ba4,631,85,716,0
answer_question,2025-02-28T18:51:33.327408,446545ae548543d8744f8d885ff75face3424ba4,19682,62,19744,0
filter_labels,2025-02-28T18:51:34.793225,9e794a58e511f6a6a9a13b201d652deff9f9f69a,6292,74,6366,6272
answer_question,2025-02-28T18:51:37.287179,9e794a58e511f6a6a9a13b201d652deff9f9f69a,5520,40,5560,5504
filter_labels,2025-02-28T18:51:38.277693,92d9de8e4db96e0b95a484afcd1c54c6beb62c03,1056,43,1099,1024
answer_question,2025-02-28T18:51:39.452985,92d9de8e4db96e0b95a484afcd1c54c6beb62c03,1111,34,1145,0
filter_labels,2025-02-28T18:51:41.659300,ddd10e4612006205c4b1ba050a11648071e6e429,665,123,788,0
answer_question,2025-02-28T18:51:50.785711,ddd10e4612006205c4b1ba050a11648071e6e429,22368,65,22433,0
filter_labels,2025-02-28T18:51:51.990871,682de8e45fd9688f3452bc0e18257132a8f3cff6,1595,66,1661,1536
answer_question,2025-02-28T18:51:54.006868,682de8e45fd9688f3452bc0e18257132a8f3cff6,3036,55,3091,0
filter_labels,2025-02-28T18:51:56.033488,c74139ce26a6f803725f5074a8a0f539abb99c09,10669,79,10748,10624
answer_question,2025-02-28T18:52:01.783175,c74139ce26a6f803725f5074a8a0f539abb99c09,3384,33,3417,0
filter_labels,2025-02-28T18:52:03.258064,e117005fc313bf0d49429d34bc8e1ef64de54898,1428,81,1509,1408
answer_question,2025-02-28T18:52:06.320501,e117005fc313bf0d49429d34bc8e1ef64de54898,3731,34,3765,0
filter_labels,2025-02-28T18:52:07.321065,553afbf09b6d83166b17acb02431c6cf38e4defc,842,57,899,0
answer_question,2025-02-28T18:52:09.568206,553afbf09b6d83166b17acb02431c6cf38e4defc,2263,50,2313,2176
filter_labels,2025-02-28T18:52:11.086243,1af8f906e34af6e0acfe4f73e37093bbe34700f3,1626,94,1720,1536
answer_question,2025-02-28T18:52:12.847812,1af8f906e34af6e0acfe4f73e37093bbe34700f3,4572,34,4606,0
filter_labels,2025-02-28T18:52:14.747485,e30ece688caf7602b734bbbcf39559b4acdb2739,1734,75,1809,1664
answer_question,2025-02-28T18:52:16.838710,e30ece688caf7602b734bbbcf39559b4acdb2739,4937,50,4987,4864
filter_labels,2025-02-28T18:52:17.968069,0a61a353b1ea9fd9b8f63b60239634ca3007d58f,2244,50,2294,2176
answer_question,2025-02-28T18:52:20.223916,0a61a353b1ea9fd9b8f63b60239634ca3007d58f,2042,70,2112,0
filter_labels,2025-02-28T18:52:21.802482,a85dba6c75031912d56a811637f803ba4ddeb257,1913,109,2022,0
answer_question,2025-02-28T18:52:24.820710,a85dba6c75031912d56a811637f803ba4ddeb257,8398,49,8447,0
filter_labels,2025-02-28T18:52:26.163481,aa781901e117281bfee6f8e4bea6fc9c9bada62e,2350,69,2419,0
answer_question,2025-02-28T18:52:27.828536,aa781901e117281bfee6f8e4bea6fc9c9bada62e,2898,30,2928,0
filter_labels,2025-02-28T18:52:29.271616,e30ece688caf7602b734bbbcf39559b4acdb2739,1716,91,1807,0
answer_question,2025-02-28T18:52:31.283743,e30ece688caf7602b734bbbcf39559b4acdb2739,4919,33,4952,0
filter_labels,2025-02-28T18:52:32.505537,36dd058d3237202cbb94139611c8b8a35ff8c158,878,75,953,0
answer_question,2025-02-28T18:52:37.338424,36dd058d3237202cbb94139611c8b8a35ff8c158,3324,83,3407,0
filter_labels,2025-02-28T18:52:38.600549,5a24fa827d172a7669eca206b2a5f47c2b19b48d,903,60,963,0
answer_question,2025-02-28T18:52:41.268686,5a24fa827d172a7669eca206b2a5f47c2b19b48d,4148,72,4220,0
filter_labels,2025-02-28T18:52:42.587935,6d76ccb75bbf1b27ca60b8419c5343ac050cebb0,1127,74,1201,0
answer_question,2025-02-28T18:52:44.641150,6d76ccb75bbf1b27ca60b8419c5343ac050cebb0,1985,34,2019,0
filter_labels,2025-02-28T18:52:46.466919,e117005fc313bf0d49429d34bc8e1ef64de54898,1435,129,1564,0
filter_labels,2025-02-28T18:54:43.998021,ecabab4934d4b80570c4bb3b8e35b7476694b3fb,1530,50,1580,1408
answer_question,2025-02-28T18:54:45.994908,ecabab4934d4b80570c4bb3b8e35b7476694b3fb,2331,47,2378,2304
filter_labels,2025-02-28T18:54:47.367696,446545ae548543d8744f8d885ff75face3424ba4,631,85,716,0
answer_question,2025-02-28T18:54:53.249344,446545ae548543d8744f8d885ff75face3424ba4,18794,62,18856,0
filter_labels,2025-02-28T18:54:54.662254,9e794a58e511f6a6a9a13b201d652deff9f9f69a,6292,85,6377,6272
answer_question,2025-02-28T18:54:57.200231,9e794a58e511f6a6a9a13b201d652deff9f9f69a,5520,40,5560,0
filter_labels,2025-02-28T18:54:58.320478,92d9de8e4db96e0b95a484afcd1c54c6beb62c03,1056,41,1097,1024
answer_question,2025-02-28T18:55:01.499830,92d9de8e4db96e0b95a484afcd1c54c6beb62c03,1111,34,1145,1024
filter_labels,2025-02-28T18:55:02.260566,ddd10e4612006205c4b1ba050a11648071e6e429,665,30,695,0
answer_question,2025-02-28T18:55:03.203258,ddd10e4612006205c4b1ba050a11648071e6e429,573,33,606,0
filter_labels,2025-02-28T18:55:04.451300,682de8e45fd9688f3452bc0e18257132a8f3cff6,1595,55,1650,1536
answer_question,2025-02-28T18:55:06.373509,682de8e45fd9688f3452bc0e18257132a8f3cff6,3036,55,3091,2944
filter_labels,2025-02-28T18:55:08.137302,c74139ce26a6f803725f5074a8a0f539abb99c09,10669,94,10763,10624
answer_question,2025-02-28T18:55:13.806950,c74139ce26a6f803725f5074a8a0f539abb99c09,3384,33,3417,3328
filter_labels,2025-02-28T18:55:15.309254,e117005fc313bf0d49429d34bc8e1ef64de54898,1428,86,1514,0
answer_question,2025-02-28T18:55:18.518497,e117005fc313bf0d49429d34bc8e1ef64de54898,3731,34,3765,3712
filter_labels,2025-02-28T18:55:21.212269,553afbf09b6d83166b17acb02431c6cf38e4defc,842,77,919,0
answer_question,2025-02-28T18:55:23.206605,553afbf09b6d83166b17acb02431c6cf38e4defc,2263,37,2300,2176
filter_labels,2025-02-28T18:55:27.266254,1af8f906e34af6e0acfe4f73e37093bbe34700f3,1626,128,1754,1536
answer_question,2025-02-28T18:55:29.615947,1af8f906e34af6e0acfe4f73e37093bbe34700f3,4491,34,4525,0
filter_labels,2025-02-28T18:55:31.445297,e30ece688caf7602b734bbbcf39559b4acdb2739,1734,87,1821,1664
answer_question,2025-02-28T18:55:33.568103,e30ece688caf7602b734bbbcf39559b4acdb2739,4937,50,4987,4864
filter_labels,2025-02-28T18:55:34.779884,0a61a353b1ea9fd9b8f63b60239634ca3007d58f,2244,67,2311,2176
answer_question,2025-02-28T18:55:36.787781,0a61a353b1ea9fd9b8f63b60239634ca3007d58f,2042,70,2112,1920
filter_labels,2025-02-28T18:55:39.265482,a85dba6c75031912d56a811637f803ba4ddeb257,1913,121,2034,1792
answer_question,2025-02-28T18:55:42.345414,a85dba6c75031912d56a811637f803ba4ddeb257,8398,49,8447,8320
filter_labels,2025-02-28T18:55:43.697126,aa781901e117281bfee6f8e4bea6fc9c9bada62e,2350,68,2418,2304
answer_question,2025-02-28T18:55:45.374840,aa781901e117281bfee6f8e4bea6fc9c9bada62e,2898,30,2928,2816
filter_labels,2025-02-28T18:55:47.019095,e30ece688caf7602b734bbbcf39559b4acdb2739,1716,89,1805,1664
answer_question,2025-02-28T18:55:48.808626,e30ece688caf7602b734bbbcf39559b4acdb2739,4919,33,4952,4864
filter_labels,2025-02-28T18:55:53.839948,36dd058d3237202cbb94139611c8b8a35ff8c158,878,71,949,0
answer_question,2025-02-28T18:55:55.980177,36dd058d3237202cbb94139611c8b8a35ff8c158,3324,50,3374,3200
filter_labels,2025-02-28T18:55:57.037268,5a24fa827d172a7669eca206b2a5f47c2b19b48d,903,63,966,0
answer_question,2025-02-28T18:56:00.110663,5a24fa827d172a7669eca206b2a5f47c2b19b48d,4148,72,4220,4096
filter_labels,2025-02-28T18:56:01.333796,6d76ccb75bbf1b27ca60b8419c5343ac050cebb0,1127,67,1194,1024
answer_question,2025-02-28T18:56:03.757128,6d76ccb75bbf1b27ca60b8419c5343ac050cebb0,3105,68,3173,0
filter_labels,2025-02-28T18:56:05.452552,e117005fc313bf0d49429d34bc8e1ef64de54898,1435,112,1547,0
answer_question,2025-02-28T18:56:09.858019,e117005fc313bf0d49429d34bc8e1ef64de54898,8838,45,8883,0
filter_labels,2025-02-28T18:56:12.035846,c7475e1d98f9a46a4652e503881d4a67232b41d3,1956,75,2031,0
answer_question,2025-02-28T18:56:13.590719,c7475e1d98f9a46a4652e503881d4a67232b41d3,2203,37,2240,0
filter_labels,2025-02-28T18:56:14.858140,4d3e52b69b4b5366e54ce87cf641b01b1419bdee,2043,66,2109,0
answer_question,2025-02-28T18:56:17.889556,4d3e52b69b4b5366e54ce87cf641b01b1419bdee,5997,47,6044,0
filter_labels,2025-02-28T18:56:20.084014,13999998018cc53440310d94a26d1e8957e2277f,2010,146,2156,0
answer_question,2025-02-28T18:56:27.590904,13999998018cc53440310d94a26d1e8957e2277f,25164,46,25210,0
answer_question,2025-02-28T18:56:41.481774,,864,110,974,0
filter_labels,2025-02-28T19:05:25.937086,ecabab4934d4b80570c4bb3b8e35b7476694b3fb,1530,50,1580,1408
answer_question,2025-02-28T19:05:28.222105,ecabab4934d4b80570c4bb3b8e35b7476694b3fb,2331,47,2378,2304
filter_labels,2025-02-28T19:05:30.381844,446545ae548543d8744f8d885ff75face3424ba4,631,81,712,0
answer_question,2025-02-28T19:05:34.069487,446545ae548543d8744f8d885ff75face3424ba4,9709,62,9771,0
filter_labels,2025-02-28T19:05:35.958603,9e794a58e511f6a6a9a13b201d652deff9f9f69a,6292,57,6349,6272
answer_question,2025-02-28T19:05:38.365344,9e794a58e511f6a6a9a13b201d652deff9f9f69a,5520,40,5560,5504
filter_labels,2025-02-28T19:05:40.695397,92d9de8e4db96e0b95a484afcd1c54c6beb62c03,1056,53,1109,1024
answer_question,2025-02-28T19:05:42.326282,92d9de8e4db96e0b95a484afcd1c54c6beb62c03,1111,34,1145,1024
filter_labels,2025-02-28T19:05:44.292371,ddd10e4612006205c4b1ba050a11648071e6e429,665,124,789,0
answer_question,2025-02-28T19:05:53.535633,ddd10e4612006205c4b1ba050a11648071e6e429,21390,65,21455,0
filter_labels,2025-02-28T19:05:55.432776,682de8e45fd9688f3452bc0e18257132a8f3cff6,1595,70,1665,1536
answer_question,2025-02-28T19:05:57.678870,682de8e45fd9688f3452bc0e18257132a8f3cff6,3036,89,3125,2944
filter_labels,2025-02-28T19:05:59.182010,c74139ce26a6f803725f5074a8a0f539abb99c09,10669,61,10730,10624
answer_question,2025-02-28T19:06:05.513247,c74139ce26a6f803725f5074a8a0f539abb99c09,3384,33,3417,3328
filter_labels,2025-02-28T19:06:07.212981,e117005fc313bf0d49429d34bc8e1ef64de54898,1428,104,1532,1408
answer_question,2025-02-28T19:06:10.581481,e117005fc313bf0d49429d34bc8e1ef64de54898,3731,34,3765,3712
filter_labels,2025-02-28T19:06:11.688664,553afbf09b6d83166b17acb02431c6cf38e4defc,842,60,902,0
answer_question,2025-02-28T19:06:14.418563,553afbf09b6d83166b17acb02431c6cf38e4defc,2263,71,2334,2176
filter_labels,2025-02-28T19:06:15.692942,1af8f906e34af6e0acfe4f73e37093bbe34700f3,1626,55,1681,1536
answer_question,2025-02-28T19:06:17.346033,1af8f906e34af6e0acfe4f73e37093bbe34700f3,3518,34,3552,0
filter_labels,2025-02-28T19:06:19.109934,e30ece688caf7602b734bbbcf39559b4acdb2739,1734,71,1805,1664
answer_question,2025-02-28T19:06:21.407086,e30ece688caf7602b734bbbcf39559b4acdb2739,4937,50,4987,4864
filter_labels,2025-02-28T19:06:23.009081,0a61a353b1ea9fd9b8f63b60239634ca3007d58f,2244,73,2317,2176
answer_question,2025-02-28T19:06:26.410569,0a61a353b1ea9fd9b8f63b60239634ca3007d58f,4331,70,4401,0
filter_labels,2025-02-28T19:06:28.700902,a85dba6c75031912d56a811637f803ba4ddeb257,1913,120,2033,1792
answer_question,2025-02-28T19:06:31.470847,a85dba6c75031912d56a811637f803ba4ddeb257,8398,49,8447,8320
filter_labels,2025-02-28T19:06:33.117765,aa781901e117281bfee6f8e4bea6fc9c9bada62e,2350,65,2415,2304
answer_question,2025-02-28T19:06:35.101257,aa781901e117281bfee6f8e4bea6fc9c9bada62e,2898,64,2962,2816
filter_labels,2025-02-28T19:06:37.181909,e30ece688caf7602b734bbbcf39559b4acdb2739,1716,71,1787,1664
answer_question,2025-02-28T19:06:39.318790,e30ece688caf7602b734bbbcf39559b4acdb2739,3261,64,3325,0
filter_labels,2025-02-28T19:06:41.262936,36dd058d3237202cbb94139611c8b8a35ff8c158,878,92,970,0
answer_question,2025-02-28T19:06:43.423099,36dd058d3237202cbb94139611c8b8a35ff8c158,3324,36,3360,3200
filter_labels,2025-02-28T19:06:44.810758,5a24fa827d172a7669eca206b2a5f47c2b19b48d,903,65,968,0
answer_question,2025-02-28T19:06:48.377130,5a24fa827d172a7669eca206b2a5f47c2b19b48d,4148,72,4220,4096
filter_labels,2025-02-28T19:06:51.291199,6d76ccb75bbf1b27ca60b8419c5343ac050cebb0,1127,101,1228,1024
answer_question,2025-02-28T19:06:53.555875,6d76ccb75bbf1b27ca60b8419c5343ac050cebb0,3105,34,3139,3072
filter_labels,2025-02-28T19:06:55.153366,e117005fc313bf0d49429d34bc8e1ef64de54898,1435,92,1527,1408
answer_question,2025-02-28T19:06:59.330626,e117005fc313bf0d49429d34bc8e1ef64de54898,8838,44,8882,8832
filter_labels,2025-02-28T19:07:00.563963,c7475e1d98f9a46a4652e503881d4a67232b41d3,1956,69,2025,1920
answer_question,2025-02-28T19:07:02.144671,c7475e1d98f9a46a4652e503881d4a67232b41d3,2203,37,2240,2176
filter_labels,2025-02-28T19:07:03.520891,4d3e52b69b4b5366e54ce87cf641b01b1419bdee,2043,61,2104,1920
answer_question,2025-02-28T19:07:06.253090,4d3e52b69b4b5366e54ce87cf641b01b1419bdee,5997,47,6044,5888
filter_labels,2025-02-28T19:07:08.245069,13999998018cc53440310d94a26d1e8957e2277f,2010,144,2154,1920
answer_question,2025-02-28T19:07:19.186452,13999998018cc53440310d94a26d1e8957e2277f,25164,89,25253,25088
answer_question,2025-02-28T19:07:36.023473,,862,111,973,0
filter_labels,2025-02-28T19:07:37.630710,0a61a353b1ea9fd9b8f63b60239634ca3007d58f,2250,103,2353,0
answer_question,2025-02-28T19:07:43.932396,0a61a353b1ea9fd9b8f63b60239634ca3007d58f,19902,39,19941,0
answer_question,2025-02-28T19:08:07.390391,,881,104,985,0
filter_labels,2025-02-28T19:08:08.657058,f879b3a802ccd6e8e6ca0a07ed8464318b7c0724,2368,47,2415,0
answer_question,2025-02-28T19:08:11.213838,f879b3a802ccd6e8e6ca0a07ed8464318b7c0724,1241,46,1287,0
filter_labels,2025-02-28T19:08:12.341834,74c690176ce433301f4d1e808bb002a2f4dc321a,1279,55,1334,0
answer_question,2025-02-28T19:08:14.286590,74c690176ce433301f4d1e808bb002a2f4dc321a,1138,47,1185,0
filter_labels,2025-02-28T19:08:16.280587,f015d4bfeec43fe65c003b6f4420ae864efbb58f,1081,68,1149,0
answer_question,2025-02-28T19:08:18.299918,f015d4bfeec43fe65c003b6f4420ae864efbb58f,3145,43,3188,0
filter_labels,2025-02-28T19:08:19.886840,a69ebee82a9acd54117407ca3697db0d7bfbfdac,3209,63,3272,0
answer_question,2025-02-28T19:08:22.587933,a69ebee82a9acd54117407ca3697db0d7bfbfdac,1766,48,1814,0
filter_labels,2025-02-28T19:08:23.910552,980742aa08ea64d552c153bcefbd7e8243fb9efd,1264,53,1317,0
answer_question,2025-02-28T19:08:25.347704,980742aa08ea64d552c153bcefbd7e8243fb9efd,1320,31,1351,0
filter_labels,2025-02-28T19:08:27.430195,6529fba868216a923407fb0d4e15a811a8e89ebc,1382,96,1478,0
answer_question,2025-02-28T19:08:38.399252,6529fba868216a923407fb0d4e15a811a8e89ebc,8070,67,8137,0
filter_labels,2025-02-28T19:08:40.857023,e30ece688caf7602b734bbbcf39559b4acdb2739,1729,97,1826,0
answer_question,2025-02-28T19:08:43.012465,e30ece688caf7602b734bbbcf39559b4acdb2739,4932,45,4977,0
filter_labels,2025-02-28T19:08:44.006990,b947c33b370d8a3251ef9c36ce7d71e8d16f4f8e,1798,39,1837,0
answer_question,2025-02-28T19:08:45.820239,b947c33b370d8a3251ef9c36ce7d71e8d16f4f8e,1758,58,1816,0
filter_labels,2025-02-28T19:08:46.885664,6529fba868216a923407fb0d4e15a811a8e89ebc,1384,50,1434,0
answer_question,2025-02-28T19:08:48.797172,6529fba868216a923407fb0d4e15a811a8e89ebc,989,35,1024,0
filter_labels,2025-02-28T19:08:50.026541,c06d5ad4b6408fec26675d30b37a6042c007095a,1106,49,1155,0
answer_question,2025-02-28T19:08:52.640749,c06d5ad4b6408fec26675d30b37a6042c007095a,2008,69,2077,0
filter_labels,2025-02-28T19:08:54.020794,4e3efdc544140b872a59e124443a64c34f356911,798,61,859,0
answer_question,2025-02-28T19:08:59.517488,4e3efdc544140b872a59e124443a64c34f356911,2038,68,2106,0
filter_labels,2025-02-28T19:09:01.096206,aa781901e117281bfee6f8e4bea6fc9c9bada62e,2374,72,2446,0
answer_question,2025-02-28T19:09:07.076150,aa781901e117281bfee6f8e4bea6fc9c9bada62e,5991,81,6072,0
filter_labels,2025-02-28T19:09:08.803125,105688726e097505beef4934896193ac51295037,1218,107,1325,0
answer_question,2025-02-28T19:09:11.229867,105688726e097505beef4934896193ac51295037,5683,45,5728,0
filter_labels,2025-02-28T19:09:12.620695,1a12ef3f11a64e92eeca39e493a17d2860c014a6,3000,41,3041,0
answer_question,2025-02-28T19:09:14.570293,1a12ef3f11a64e92eeca39e493a17d2860c014a6,1630,48,1678,0
filter_labels,2025-02-28T19:09:15.986770,aa781901e117281bfee6f8e4bea6fc9c9bada62e,2348,50,2398,0
answer_question,2025-02-28T19:09:17.919417,aa781901e117281bfee6f8e4bea6fc9c9bada62e,2950,28,2978,0
filter_labels,2025-02-28T19:09:19.254173,d14ae2b6284e48b5c1e6659a0a5863d84697b3b9,1121,68,1189,0
answer_question,2025-02-28T19:09:20.755811,d14ae2b6284e48b5c1e6659a0a5863d84697b3b9,1251,38,1289,0
answer_question,2025-02-28T19:09:43.476721,,876,109,985,0
filter_labels,2025-02-28T19:09:44.559875,35839effbc332f23d5f34263aab3dcb2c6976420,1180,55,1235,0
answer_question,2025-02-28T19:09:47.262930,35839effbc332f23d5f34263aab3dcb2c6976420,5422,35,5457,0
filter_labels,2025-02-28T19:09:48.617201,78c71282723c2d66216cbba13183d19349d302b8,3049,52,3101,0
answer_question,2025-02-28T19:09:51.130595,78c71282723c2d66216cbba13183d19349d302b8,1934,89,2023,0
filter_labels,2025-02-28T19:09:52.743041,da663e46fbf02ec8a90b3f3c1079ef4c9f7907e1,3506,90,3596,0
labeling,2025-02-28T19:15:46.509217,da663e46fbf02ec8a90b3f3c1079ef4c9f7907e1,10246,405,10651,0
labeling,2025-02-28T19:15:54.313648,da663e46fbf02ec8a90b3f3c1079ef4c9f7907e1,10437,287,10724,0
labeling,2025-02-28T19:15:59.199691,da663e46fbf02ec8a90b3f3c1079ef4c9f7907e1,10404,185,10589,0
labeling,2025-02-28T19:16:10.690170,da663e46fbf02ec8a90b3f3c1079ef4c9f7907e1,10676,361,11037,0
labeling,2025-02-28T19:16:33.229668,da663e46fbf02ec8a90b3f3c1079ef4c9f7907e1,10477,229,10706,0
labeling,2025-02-28T19:17:03.754235,da663e46fbf02ec8a90b3f3c1079ef4c9f7907e1,10738,599,11337,0
labeling,2025-02-28T19:17:21.514963,da663e46fbf02ec8a90b3f3c1079ef4c9f7907e1,10429,770,11199,0
labeling,2025-02-28T19:17:53.318091,da663e46fbf02ec8a90b3f3c1079ef4c9f7907e1,10131,1139,11270,0
labeling,2025-02-28T19:17:55.592621,da663e46fbf02ec8a90b3f3c1079ef4c9f7907e1,10712,55,10767,0
labeling,2025-02-28T19:17:59.595290,da663e46fbf02ec8a90b3f3c1079ef4c9f7907e1,2689,61,2750,0
filter_labels,2025-02-28T19:19:12.066377,ecabab4934d4b80570c4bb3b8e35b7476694b3fb,1530,64,1594,1408
answer_question,2025-02-28T19:19:14.246109,ecabab4934d4b80570c4bb3b8e35b7476694b3fb,2331,47,2378,0
filter_labels,2025-02-28T19:19:16.261862,446545ae548543d8744f8d885ff75face3424ba4,631,125,756,0
answer_question,2025-02-28T19:19:22.595802,446545ae548543d8744f8d885ff75face3424ba4,19682,62,19744,0
filter_labels,2025-02-28T19:19:23.987908,9e794a58e511f6a6a9a13b201d652deff9f9f69a,6292,74,6366,6272
answer_question,2025-02-28T19:19:27.267184,9e794a58e511f6a6a9a13b201d652deff9f9f69a,5520,78,5598,0
filter_labels,2025-02-28T19:19:28.490585,92d9de8e4db96e0b95a484afcd1c54c6beb62c03,1056,46,1102,1024
answer_question,2025-02-28T19:19:29.725539,92d9de8e4db96e0b95a484afcd1c54c6beb62c03,1111,34,1145,0
filter_labels,2025-02-28T19:19:31.260979,ddd10e4612006205c4b1ba050a11648071e6e429,665,65,730,0
answer_question,2025-02-28T19:19:33.077748,ddd10e4612006205c4b1ba050a11648071e6e429,2841,65,2906,0
filter_labels,2025-02-28T19:19:34.587054,682de8e45fd9688f3452bc0e18257132a8f3cff6,1595,62,1657,1536
answer_question,2025-02-28T19:19:36.325701,682de8e45fd9688f3452bc0e18257132a8f3cff6,3036,50,3086,2944
filter_labels,2025-02-28T19:19:37.717590,c74139ce26a6f803725f5074a8a0f539abb99c09,10669,58,10727,10624
answer_question,2025-02-28T19:19:43.138483,c74139ce26a6f803725f5074a8a0f539abb99c09,3384,33,3417,3328
filter_labels,2025-02-28T19:19:45.070549,e117005fc313bf0d49429d34bc8e1ef64de54898,1428,96,1524,1408
answer_question,2025-02-28T19:19:48.332471,e117005fc313bf0d49429d34bc8e1ef64de54898,3731,34,3765,3712
filter_labels,2025-02-28T19:19:49.388731,553afbf09b6d83166b17acb02431c6cf38e4defc,842,55,897,0
answer_question,2025-02-28T19:19:51.642684,553afbf09b6d83166b17acb02431c6cf38e4defc,2263,50,2313,0
filter_labels,2025-02-28T19:19:53.333035,1af8f906e34af6e0acfe4f73e37093bbe34700f3,1626,100,1726,1536
answer_question,2025-02-28T19:19:55.432815,1af8f906e34af6e0acfe4f73e37093bbe34700f3,4927,69,4996,0
filter_labels,2025-02-28T19:19:57.829772,e30ece688caf7602b734bbbcf39559b4acdb2739,1734,115,1849,1664
answer_question,2025-02-28T19:20:00.230761,e30ece688caf7602b734bbbcf39559b4acdb2739,4937,51,4988,4864
filter_labels,2025-02-28T19:20:01.322825,0a61a353b1ea9fd9b8f63b60239634ca3007d58f,2244,66,2310,2176
answer_question,2025-02-28T19:20:03.522597,0a61a353b1ea9fd9b8f63b60239634ca3007d58f,2042,70,2112,0
filter_labels,2025-02-28T19:20:05.963841,a85dba6c75031912d56a811637f803ba4ddeb257,1913,132,2045,1792
answer_question,2025-02-28T19:20:08.950063,a85dba6c75031912d56a811637f803ba4ddeb257,8398,49,8447,8320
filter_labels,2025-02-28T19:20:10.081358,aa781901e117281bfee6f8e4bea6fc9c9bada62e,2350,64,2414,2304
answer_question,2025-02-28T19:20:12.391092,aa781901e117281bfee6f8e4bea6fc9c9bada62e,2898,30,2928,0
filter_labels,2025-02-28T19:20:16.588860,e30ece688caf7602b734bbbcf39559b4acdb2739,1716,109,1825,1664
answer_question,2025-02-28T19:20:18.645762,e30ece688caf7602b734bbbcf39559b4acdb2739,4919,33,4952,0
filter_labels,2025-02-28T19:20:19.819151,36dd058d3237202cbb94139611c8b8a35ff8c158,878,78,956,0
answer_question,2025-02-28T19:20:21.950578,36dd058d3237202cbb94139611c8b8a35ff8c158,3324,36,3360,0
filter_labels,2025-02-28T19:20:22.981769,5a24fa827d172a7669eca206b2a5f47c2b19b48d,903,56,959,0
answer_question,2025-02-28T19:20:25.852792,5a24fa827d172a7669eca206b2a5f47c2b19b48d,4148,72,4220,0
filter_labels,2025-02-28T19:20:27.165562,6d76ccb75bbf1b27ca60b8419c5343ac050cebb0,1127,78,1205,1024
answer_question,2025-02-28T19:20:29.675771,6d76ccb75bbf1b27ca60b8419c5343ac050cebb0,3105,34,3139,3072
filter_labels,2025-02-28T19:20:31.139419,e117005fc313bf0d49429d34bc8e1ef64de54898,1435,101,1536,1408
answer_question,2025-02-28T19:20:35.157998,e117005fc313bf0d49429d34bc8e1ef64de54898,8912,44,8956,0
filter_labels,2025-02-28T19:20:36.067618,c7475e1d98f9a46a4652e503881d4a67232b41d3,1956,46,2002,1920
answer_question,2025-02-28T19:20:37.722587,c7475e1d98f9a46a4652e503881d4a67232b41d3,2203,37,2240,2176
filter_labels,2025-02-28T19:20:38.907218,4d3e52b69b4b5366e54ce87cf641b01b1419bdee,2043,69,2112,1920
answer_question,2025-02-28T19:20:41.714686,4d3e52b69b4b5366e54ce87cf641b01b1419bdee,5997,47,6044,0
filter_labels,2025-02-28T19:20:43.351137,13999998018cc53440310d94a26d1e8957e2277f,2010,104,2114,1920
answer_question,2025-02-28T19:20:49.595507,13999998018cc53440310d94a26d1e8957e2277f,25164,46,25210,25088
answer_question,2025-02-28T19:21:06.635460,,867,73,940,0
filter_labels,2025-02-28T19:21:08.287670,0a61a353b1ea9fd9b8f63b60239634ca3007d58f,2250,83,2333,2176
answer_question,2025-02-28T19:21:29.232518,0a61a353b1ea9fd9b8f63b60239634ca3007d58f,2805,39,2844,0
answer_question,2025-02-28T19:21:50.116772,,878,68,946,0
filter_labels,2025-02-28T19:21:51.245220,f879b3a802ccd6e8e6ca0a07ed8464318b7c0724,2368,55,2423,2304
answer_question,2025-02-28T19:21:52.831877,f879b3a802ccd6e8e6ca0a07ed8464318b7c0724,1241,46,1287,1152
filter_labels,2025-02-28T19:21:53.757933,74c690176ce433301f4d1e808bb002a2f4dc321a,1279,52,1331,1152
answer_question,2025-02-28T19:21:55.649936,74c690176ce433301f4d1e808bb002a2f4dc321a,1138,47,1185,0
filter_labels,2025-02-28T19:21:57.159870,f015d4bfeec43fe65c003b6f4420ae864efbb58f,1081,77,1158,1024
answer_question,2025-02-28T19:21:59.045874,f015d4bfeec43fe65c003b6f4420ae864efbb58f,3145,43,3188,0
filter_labels,2025-02-28T19:21:59.946964,a69ebee82a9acd54117407ca3697db0d7bfbfdac,3209,38,3247,3200
answer_question,2025-02-28T19:22:02.270922,a69ebee82a9acd54117407ca3697db0d7bfbfdac,1766,48,1814,1664
filter_labels,2025-02-28T19:22:03.125833,980742aa08ea64d552c153bcefbd7e8243fb9efd,1264,43,1307,1152
answer_question,2025-02-28T19:22:05.131730,980742aa08ea64d552c153bcefbd7e8243fb9efd,1320,31,1351,1280
filter_labels,2025-02-28T19:22:06.750679,6529fba868216a923407fb0d4e15a811a8e89ebc,1382,100,1482,1280
answer_question,2025-02-28T19:22:10.143423,6529fba868216a923407fb0d4e15a811a8e89ebc,2888,67,2955,0
filter_labels,2025-02-28T19:22:11.260348,e30ece688caf7602b734bbbcf39559b4acdb2739,1729,69,1798,1664
answer_question,2025-02-28T19:22:13.356229,e30ece688caf7602b734bbbcf39559b4acdb2739,4932,45,4977,4864
filter_labels,2025-02-28T19:22:14.297023,b947c33b370d8a3251ef9c36ce7d71e8d16f4f8e,1798,46,1844,1792
answer_question,2025-02-28T19:22:15.789084,b947c33b370d8a3251ef9c36ce7d71e8d16f4f8e,1758,39,1797,1664
filter_labels,2025-02-28T19:22:16.676133,6529fba868216a923407fb0d4e15a811a8e89ebc,1384,43,1427,1280
answer_question,2025-02-28T19:22:18.378674,6529fba868216a923407fb0d4e15a811a8e89ebc,989,35,1024,0
filter_labels,2025-02-28T19:22:19.328731,c06d5ad4b6408fec26675d30b37a6042c007095a,1106,43,1149,1024
answer_question,2025-02-28T19:22:21.877597,c06d5ad4b6408fec26675d30b37a6042c007095a,2008,69,2077,0
filter_labels,2025-02-28T19:22:23.084158,4e3efdc544140b872a59e124443a64c34f356911,798,86,884,0
answer_question,2025-02-28T19:22:28.575410,4e3efdc544140b872a59e124443a64c34f356911,2038,68,2106,0
filter_labels,2025-02-28T19:22:29.749374,aa781901e117281bfee6f8e4bea6fc9c9bada62e,2374,59,2433,2304
answer_question,2025-02-28T19:22:33.332125,aa781901e117281bfee6f8e4bea6fc9c9bada62e,5991,87,6078,0
filter_labels,2025-02-28T19:22:34.965385,105688726e097505beef4934896193ac51295037,1218,80,1298,1152
answer_question,2025-02-28T19:22:37.433988,105688726e097505beef4934896193ac51295037,5683,56,5739,0
filter_labels,2025-02-28T19:22:38.365092,1a12ef3f11a64e92eeca39e493a17d2860c014a6,3000,43,3043,2944
answer_question,2025-02-28T19:22:40.072478,1a12ef3f11a64e92eeca39e493a17d2860c014a6,1630,48,1678,0
filter_labels,2025-02-28T19:22:41.099593,aa781901e117281bfee6f8e4bea6fc9c9bada62e,2348,49,2397,2304
answer_question,2025-02-28T19:22:43.336197,aa781901e117281bfee6f8e4bea6fc9c9bada62e,4852,62,4914,0
filter_labels,2025-02-28T19:22:44.365125,d14ae2b6284e48b5c1e6659a0a5863d84697b3b9,1121,53,1174,1024
answer_question,2025-02-28T19:22:45.773841,d14ae2b6284e48b5c1e6659a0a5863d84697b3b9,1251,38,1289,1152
answer_question,2025-02-28T19:23:09.886764,,950,86,1036,0
filter_labels,2025-02-28T19:23:11.174091,35839effbc332f23d5f34263aab3dcb2c6976420,1180,82,1262,1152
answer_question,2025-02-28T19:23:14.166777,35839effbc332f23d5f34263aab3dcb2c6976420,4689,70,4759,0
filter_labels,2025-02-28T19:23:15.713068,78c71282723c2d66216cbba13183d19349d302b8,3049,50,3099,0
answer_question,2025-02-28T19:23:18.999038,78c71282723c2d66216cbba13183d19349d302b8,1934,89,2023,1920
filter_labels,2025-02-28T19:23:20.340945,da663e46fbf02ec8a90b3f3c1079ef4c9f7907e1,5075,55,5130,0
answer_question,2025-02-28T19:23:21.982954,da663e46fbf02ec8a90b3f3c1079ef4c9f7907e1,1610,37,1647,0
filter_labels,2025-02-28T19:23:23.401257,682de8e45fd9688f3452bc0e18257132a8f3cff6,1584,55,1639,0
answer_question,2025-02-28T19:23:25.547500,682de8e45fd9688f3452bc0e18257132a8f3cff6,2609,45,2654,0
filter_labels,2025-02-28T19:23:27.754003,0279901b645e568591ad95dac2c2bf939ef0c00d,3322,148,3470,0
answer_question,2025-02-28T19:23:32.006967,0279901b645e568591ad95dac2c2bf939ef0c00d,10684,66,10750,0
filter_labels,2025-02-28T19:23:33.549396,74c690176ce433301f4d1e808bb002a2f4dc321a,1277,75,1352,0
answer_question,2025-02-28T19:23:35.893401,74c690176ce433301f4d1e808bb002a2f4dc321a,2621,45,2666,0
filter_labels,2025-02-28T19:23:37.128659,30f64d1043f4cb425eb636763580ae27094ffef1,2005,76,2081,0
answer_question,2025-02-28T19:23:41.154231,30f64d1043f4cb425eb636763580ae27094ffef1,3764,53,3817,0
filter_labels,2025-02-28T19:23:42.489741,74c690176ce433301f4d1e808bb002a2f4dc321a,1273,65,1338,0
answer_question,2025-02-28T19:23:44.356979,74c690176ce433301f4d1e808bb002a2f4dc321a,3120,38,3158,0
filter_labels,2025-02-28T19:23:45.681018,3f36d4f26ada778d89cf5a7344be0b9e9a5223a3,1396,89,1485,0
answer_question,2025-02-28T19:23:51.008638,3f36d4f26ada778d89cf5a7344be0b9e9a5223a3,10736,88,10824,0
filter_labels,2025-02-28T19:23:52.175287,78c71282723c2d66216cbba13183d19349d302b8,3026,52,3078,0
answer_question,2025-02-28T19:23:54.752296,78c71282723c2d66216cbba13183d19349d302b8,4039,66,4105,0
filter_labels,2025-02-28T19:23:56.174061,696ddc4c80febe0f1559ed3b1272487c74ca91cc,1365,93,1458,0
answer_question,2025-02-28T19:23:59.130986,696ddc4c80febe0f1559ed3b1272487c74ca91cc,1730,37,1767,0
answer_question,2025-02-28T19:24:17.580541,,876,89,965,0
filter_labels,2025-02-28T19:24:19.287870,a69ebee82a9acd54117407ca3697db0d7bfbfdac,3209,56,3265,0
answer_question,2025-02-28T19:24:22.099061,a69ebee82a9acd54117407ca3697db0d7bfbfdac,1766,38,1804,0
filter_labels,2025-02-28T19:24:24.012500,cc0fc5888b99758100a7ff024863fc4337b6b3c5,6017,76,6093,0
answer_question,2025-02-28T19:24:27.713802,cc0fc5888b99758100a7ff024863fc4337b6b3c5,10072,45,10117,0
answer_question,2025-02-28T19:24:44.022668,,883,108,991,0
filter_labels,2025-02-28T19:24:46.006184,da663e46fbf02ec8a90b3f3c1079ef4c9f7907e1,5093,107,5200,0
answer_question,2025-02-28T19:24:49.429999,da663e46fbf02ec8a90b3f3c1079ef4c9f7907e1,6170,84,6254,0
filter_labels,2025-02-28T19:24:50.958031,3bb894b4201667baf60b0b2c8a47109fa2357acb,882,100,982,0
answer_question,2025-02-28T19:24:52.245597,3bb894b4201667baf60b0b2c8a47109fa2357acb,2593,46,2639,0
filter_labels,2025-02-28T19:24:53.929985,da663e46fbf02ec8a90b3f3c1079ef4c9f7907e1,5097,97,5194,0
answer_question,2025-02-28T19:24:56.058966,da663e46fbf02ec8a90b3f3c1079ef4c9f7907e1,2749,49,2798,0
answer_question,2025-02-28T19:25:15.528706,,865,100,965,0
filter_labels,2025-02-28T19:25:16.836449,67185fca2a09b3c46ee961b2c1ae160dab8b5231,1099,59,1158,0
answer_question,2025-02-28T19:25:23.441239,67185fca2a09b3c46ee961b2c1ae160dab8b5231,948,45,993,0
labeling,2025-02-28T19:28:03.777068,e7a45fed0d7ebfd13a524e7fcc443318bac654e2,9967,908,10875,0
labeling,2025-02-28T19:28:12.415628,e7a45fed0d7ebfd13a524e7fcc443318bac654e2,10672,324,10996,0
labeling,2025-02-28T19:28:28.498996,e7a45fed0d7ebfd13a524e7fcc443318bac654e2,10001,355,10356,0
labeling,2025-02-28T19:28:45.977617,e7a45fed0d7ebfd13a524e7fcc443318bac654e2,10118,386,10504,0
labeling,2025-02-28T19:29:02.556219,e7a45fed0d7ebfd13a524e7fcc443318bac654e2,9661,549,10210,0
labeling,2025-02-28T19:29:27.241492,e7a45fed0d7ebfd13a524e7fcc443318bac654e2,10424,998,11422,0
labeling,2025-02-28T19:29:41.463231,e7a45fed0d7ebfd13a524e7fcc443318bac654e2,9526,315,9841,0
labeling,2025-02-28T19:30:05.447565,e7a45fed0d7ebfd13a524e7fcc443318bac654e2,10754,730,11484,0
labeling,2025-02-28T19:30:19.781927,e7a45fed0d7ebfd13a524e7fcc443318bac654e2,10739,525,11264,0
labeling,2025-02-28T19:30:26.502408,e7a45fed0d7ebfd13a524e7fcc443318bac654e2,9935,278,10213,0
labeling,2025-02-28T19:30:39.744546,e7a45fed0d7ebfd13a524e7fcc443318bac654e2,9881,97,9978,0
labeling,2025-02-28T19:32:21.133410,e7a45fed0d7ebfd13a524e7fcc443318bac654e2,19783,581,20364,9856
labeling,2025-02-28T19:32:54.607411,e7a45fed0d7ebfd13a524e7fcc443318bac654e2,20488,447,20935,9984
labeling,2025-02-28T19:33:17.987346,e7a45fed0d7ebfd13a524e7fcc443318bac654e2,19720,368,20088,0
labeling,2025-02-28T19:34:10.846359,e7a45fed0d7ebfd13a524e7fcc443318bac654e2,20143,357,20500,0
labeling,2025-02-28T19:34:49.026345,e7a45fed0d7ebfd13a524e7fcc443318bac654e2,20357,745,21102,0
labeling,2025-02-28T19:35:24.572231,e7a45fed0d7ebfd13a524e7fcc443318bac654e2,20796,300,21096,0
labeling,2025-02-28T19:35:47.680162,e7a45fed0d7ebfd13a524e7fcc443318bac654e2,11495,299,11794,0
filter_labels,2025-02-28T19:36:45.276909,ecabab4934d4b80570c4bb3b8e35b7476694b3fb,1530,79,1609,1408
answer_question,2025-02-28T19:36:47.456258,ecabab4934d4b80570c4bb3b8e35b7476694b3fb,2331,47,2378,0
filter_labels,2025-02-28T19:36:49.610211,446545ae548543d8744f8d885ff75face3424ba4,631,137,768,0
answer_question,2025-02-28T19:37:02.253280,446545ae548543d8744f8d885ff75face3424ba4,37135,62,37197,0
filter_labels,2025-02-28T19:37:03.766601,9e794a58e511f6a6a9a13b201d652deff9f9f69a,6292,61,6353,6272
answer_question,2025-02-28T19:37:06.552992,9e794a58e511f6a6a9a13b201d652deff9f9f69a,5520,40,5560,0
filter_labels,2025-02-28T19:37:07.399090,92d9de8e4db96e0b95a484afcd1c54c6beb62c03,1056,32,1088,1024
answer_question,2025-02-28T19:37:08.401911,92d9de8e4db96e0b95a484afcd1c54c6beb62c03,1111,34,1145,0
filter_labels,2025-02-28T19:37:10.081056,ddd10e4612006205c4b1ba050a11648071e6e429,665,97,762,0
answer_question,2025-02-28T19:37:12.351827,ddd10e4612006205c4b1ba050a11648071e6e429,3691,65,3756,0
filter_labels,2025-02-28T19:37:13.311990,682de8e45fd9688f3452bc0e18257132a8f3cff6,1595,51,1646,1536
answer_question,2025-02-28T19:37:15.309285,682de8e45fd9688f3452bc0e18257132a8f3cff6,3036,55,3091,0
filter_labels,2025-02-28T19:37:17.091021,c74139ce26a6f803725f5074a8a0f539abb99c09,10669,78,10747,10624
answer_question,2025-02-28T19:37:25.817822,c74139ce26a6f803725f5074a8a0f539abb99c09,3384,33,3417,0
filter_labels,2025-02-28T19:37:27.086611,e117005fc313bf0d49429d34bc8e1ef64de54898,1428,65,1493,1408
answer_question,2025-02-28T19:37:30.371003,e117005fc313bf0d49429d34bc8e1ef64de54898,3731,34,3765,0
filter_labels,2025-02-28T19:37:31.638842,553afbf09b6d83166b17acb02431c6cf38e4defc,842,67,909,0
answer_question,2025-02-28T19:37:34.278867,553afbf09b6d83166b17acb02431c6cf38e4defc,2263,50,2313,0
filter_labels,2025-02-28T19:37:35.871688,1af8f906e34af6e0acfe4f73e37093bbe34700f3,1626,107,1733,1536
answer_question,2025-02-28T19:37:37.822693,1af8f906e34af6e0acfe4f73e37093bbe34700f3,5240,34,5274,0
filter_labels,2025-02-28T19:37:39.467865,e30ece688caf7602b734bbbcf39559b4acdb2739,1734,99,1833,1664
answer_question,2025-02-28T19:37:44.504066,e30ece688caf7602b734bbbcf39559b4acdb2739,4937,50,4987,0
filter_labels,2025-02-28T19:37:45.982908,0a61a353b1ea9fd9b8f63b60239634ca3007d58f,2244,86,2330,2176
answer_question,2025-02-28T19:37:49.343368,0a61a353b1ea9fd9b8f63b60239634ca3007d58f,4331,70,4401,0
filter_labels,2025-02-28T19:37:50.977095,a85dba6c75031912d56a811637f803ba4ddeb257,1913,113,2026,1792
answer_question,2025-02-28T19:37:53.736023,a85dba6c75031912d56a811637f803ba4ddeb257,8398,49,8447,0
filter_labels,2025-02-28T19:37:54.769112,aa781901e117281bfee6f8e4bea6fc9c9bada62e,2350,55,2405,2304
answer_question,2025-02-28T19:37:56.598502,aa781901e117281bfee6f8e4bea6fc9c9bada62e,2898,30,2928,0
filter_labels,2025-02-28T19:37:57.513560,e30ece688caf7602b734bbbcf39559b4acdb2739,1716,41,1757,1664
answer_question,2025-02-28T19:37:58.585185,e30ece688caf7602b734bbbcf39559b4acdb2739,571,33,604,0
filter_labels,2025-02-28T19:38:00.070952,36dd058d3237202cbb94139611c8b8a35ff8c158,878,76,954,0
answer_question,2025-02-28T19:38:02.519537,36dd058d3237202cbb94139611c8b8a35ff8c158,3324,69,3393,0
filter_labels,2025-02-28T19:38:03.750063,5a24fa827d172a7669eca206b2a5f47c2b19b48d,903,51,954,0
answer_question,2025-02-28T19:38:06.636126,5a24fa827d172a7669eca206b2a5f47c2b19b48d,4148,72,4220,0
filter_labels,2025-02-28T19:38:07.901512,6d76ccb75bbf1b27ca60b8419c5343ac050cebb0,1127,67,1194,1024
answer_question,2025-02-28T19:38:10.581250,6d76ccb75bbf1b27ca60b8419c5343ac050cebb0,3105,34,3139,0
filter_labels,2025-02-28T19:38:12.406761,e117005fc313bf0d49429d34bc8e1ef64de54898,1435,108,1543,1408
answer_question,2025-02-28T19:38:16.256519,e117005fc313bf0d49429d34bc8e1ef64de54898,8838,44,8882,0
filter_labels,2025-02-28T19:38:17.504007,c7475e1d98f9a46a4652e503881d4a67232b41d3,1956,71,2027,1920
answer_question,2025-02-28T19:38:18.981514,c7475e1d98f9a46a4652e503881d4a67232b41d3,2203,37,2240,0
filter_labels,2025-02-28T19:38:20.131113,4d3e52b69b4b5366e54ce87cf641b01b1419bdee,2043,62,2105,1920
answer_question,2025-02-28T19:38:22.791074,4d3e52b69b4b5366e54ce87cf641b01b1419bdee,5997,47,6044,0
filter_labels,2025-02-28T19:38:24.527795,13999998018cc53440310d94a26d1e8957e2277f,2010,108,2118,1920
answer_question,2025-02-28T19:38:31.236826,13999998018cc53440310d94a26d1e8957e2277f,25164,46,25210,0
answer_question,2025-02-28T19:38:45.652004,,865,110,975,0
filter_labels,2025-02-28T19:38:47.150747,0a61a353b1ea9fd9b8f63b60239634ca3007d58f,2250,72,2322,2176
answer_question,2025-02-28T19:38:48.802715,0a61a353b1ea9fd9b8f63b60239634ca3007d58f,1581,39,1620,0
answer_question,2025-02-28T19:39:10.457253,,875,103,978,0
filter_labels,2025-02-28T19:39:11.739373,f879b3a802ccd6e8e6ca0a07ed8464318b7c0724,2368,49,2417,2304
answer_question,2025-02-28T19:39:13.170468,f879b3a802ccd6e8e6ca0a07ed8464318b7c0724,1241,46,1287,0
filter_labels,2025-02-28T19:39:14.191014,74c690176ce433301f4d1e808bb002a2f4dc321a,1279,38,1317,1152
answer_question,2025-02-28T19:39:16.254724,74c690176ce433301f4d1e808bb002a2f4dc321a,1138,47,1185,0
filter_labels,2025-02-28T19:39:17.637877,f015d4bfeec43fe65c003b6f4420ae864efbb58f,1081,79,1160,1024
answer_question,2025-02-28T19:39:19.520398,f015d4bfeec43fe65c003b6f4420ae864efbb58f,3145,43,3188,0
filter_labels,2025-02-28T19:39:20.584387,a69ebee82a9acd54117407ca3697db0d7bfbfdac,3209,47,3256,3200
answer_question,2025-02-28T19:39:23.012647,a69ebee82a9acd54117407ca3697db0d7bfbfdac,1766,44,1810,0
filter_labels,2025-02-28T19:39:24.247027,980742aa08ea64d552c153bcefbd7e8243fb9efd,1264,49,1313,1152
answer_question,2025-02-28T19:39:25.693703,980742aa08ea64d552c153bcefbd7e8243fb9efd,1320,31,1351,0
filter_labels,2025-02-28T19:39:26.768829,6529fba868216a923407fb0d4e15a811a8e89ebc,1382,49,1431,1280
answer_question,2025-02-28T19:39:28.435430,6529fba868216a923407fb0d4e15a811a8e89ebc,575,33,608,0
filter_labels,2025-02-28T19:39:30.072094,e30ece688caf7602b734bbbcf39559b4acdb2739,1729,90,1819,1664
answer_question,2025-02-28T19:39:32.319240,e30ece688caf7602b734bbbcf39559b4acdb2739,4932,45,4977,0
filter_labels,2025-02-28T19:39:33.569775,b947c33b370d8a3251ef9c36ce7d71e8d16f4f8e,1798,70,1868,1792
answer_question,2025-02-28T19:39:35.295908,b947c33b370d8a3251ef9c36ce7d71e8d16f4f8e,1758,53,1811,0
filter_labels,2025-02-28T19:39:36.471095,6529fba868216a923407fb0d4e15a811a8e89ebc,1384,51,1435,1280
answer_question,2025-02-28T19:39:38.752240,6529fba868216a923407fb0d4e15a811a8e89ebc,989,35,1024,0
filter_labels,2025-02-28T19:39:40.106462,c06d5ad4b6408fec26675d30b37a6042c007095a,1106,52,1158,1024
answer_question,2025-02-28T19:39:42.522289,c06d5ad4b6408fec26675d30b37a6042c007095a,2008,69,2077,0
filter_labels,2025-02-28T19:39:43.837807,4e3efdc544140b872a59e124443a64c34f356911,798,62,860,0
answer_question,2025-02-28T19:39:49.536934,4e3efdc544140b872a59e124443a64c34f356911,2038,68,2106,0
filter_labels,2025-02-28T19:39:51.322809,aa781901e117281bfee6f8e4bea6fc9c9bada62e,2374,83,2457,2304
answer_question,2025-02-28T19:39:54.135003,aa781901e117281bfee6f8e4bea6fc9c9bada62e,5991,68,6059,0
filter_labels,2025-02-28T19:39:55.872378,105688726e097505beef4934896193ac51295037,1218,109,1327,1152
answer_question,2025-02-28T19:39:58.437697,105688726e097505beef4934896193ac51295037,4864,45,4909,0
filter_labels,2025-02-28T19:40:00.081918,1a12ef3f11a64e92eeca39e493a17d2860c014a6,3000,57,3057,2944
answer_question,2025-02-28T19:40:01.991081,1a12ef3f11a64e92eeca39e493a17d2860c014a6,1630,54,1684,0
filter_labels,2025-02-28T19:40:03.635397,aa781901e117281bfee6f8e4bea6fc9c9bada62e,2348,59,2407,2304
answer_question,2025-02-28T19:40:05.945202,aa781901e117281bfee6f8e4bea6fc9c9bada62e,4852,62,4914,0
filter_labels,2025-02-28T19:40:07.048498,d14ae2b6284e48b5c1e6659a0a5863d84697b3b9,1121,48,1169,1024
answer_question,2025-02-28T19:40:08.436022,d14ae2b6284e48b5c1e6659a0a5863d84697b3b9,1251,38,1289,0
answer_question,2025-02-28T19:40:28.687756,,879,103,982,0
filter_labels,2025-02-28T19:40:29.871538,35839effbc332f23d5f34263aab3dcb2c6976420,1180,70,1250,1152
answer_question,2025-02-28T19:40:32.329784,35839effbc332f23d5f34263aab3dcb2c6976420,5422,35,5457,0
filter_labels,2025-02-28T19:40:33.587833,78c71282723c2d66216cbba13183d19349d302b8,3049,61,3110,2944
answer_question,2025-02-28T19:40:36.084698,78c71282723c2d66216cbba13183d19349d302b8,1934,89,2023,0
filter_labels,2025-02-28T19:40:37.308492,da663e46fbf02ec8a90b3f3c1079ef4c9f7907e1,5075,54,5129,4992
answer_question,2025-02-28T19:40:38.982535,da663e46fbf02ec8a90b3f3c1079ef4c9f7907e1,1610,38,1648,0
filter_labels,2025-02-28T19:40:40.208994,682de8e45fd9688f3452bc0e18257132a8f3cff6,1584,60,1644,1536
answer_question,2025-02-28T19:40:41.955542,682de8e45fd9688f3452bc0e18257132a8f3cff6,3484,45,3529,0
filter_labels,2025-02-28T19:40:43.924312,0279901b645e568591ad95dac2c2bf939ef0c00d,3322,125,3447,3200
answer_question,2025-02-28T19:40:47.637740,0279901b645e568591ad95dac2c2bf939ef0c00d,7592,66,7658,0
filter_labels,2025-02-28T19:40:48.844713,74c690176ce433301f4d1e808bb002a2f4dc321a,1277,73,1350,1152
answer_question,2025-02-28T19:40:51.452223,74c690176ce433301f4d1e808bb002a2f4dc321a,2621,78,2699,0
filter_labels,2025-02-28T19:40:52.594135,30f64d1043f4cb425eb636763580ae27094ffef1,2005,66,2071,1920
answer_question,2025-02-28T19:40:55.718140,30f64d1043f4cb425eb636763580ae27094ffef1,3764,53,3817,0
filter_labels,2025-02-28T19:40:57.383649,74c690176ce433301f4d1e808bb002a2f4dc321a,1273,60,1333,1152
answer_question,2025-02-28T19:40:59.467262,74c690176ce433301f4d1e808bb002a2f4dc321a,3963,38,4001,0
filter_labels,2025-02-28T19:41:00.844743,3f36d4f26ada778d89cf5a7344be0b9e9a5223a3,1396,87,1483,1280
answer_question,2025-02-28T19:41:09.353350,3f36d4f26ada778d89cf5a7344be0b9e9a5223a3,8167,88,8255,0
filter_labels,2025-02-28T19:41:11.244708,78c71282723c2d66216cbba13183d19349d302b8,3026,131,3157,2944
answer_question,2025-02-28T19:41:14.826176,78c71282723c2d66216cbba13183d19349d302b8,5868,66,5934,0
filter_labels,2025-02-28T19:41:16.099075,696ddc4c80febe0f1559ed3b1272487c74ca91cc,1365,66,1431,1280
answer_question,2025-02-28T19:41:18.309149,696ddc4c80febe0f1559ed3b1272487c74ca91cc,794,37,831,0
answer_question,2025-02-28T19:41:36.653411,,772,104,876,0
filter_labels,2025-02-28T19:41:37.731594,a69ebee82a9acd54117407ca3697db0d7bfbfdac,3209,41,3250,3200
answer_question,2025-02-28T19:41:40.214810,a69ebee82a9acd54117407ca3697db0d7bfbfdac,1766,48,1814,0
filter_labels,2025-02-28T19:41:41.653903,cc0fc5888b99758100a7ff024863fc4337b6b3c5,6017,70,6087,5888
answer_question,2025-02-28T19:41:45.057616,cc0fc5888b99758100a7ff024863fc4337b6b3c5,10072,45,10117,0
answer_question,2025-02-28T19:42:02.965717,,881,88,969,0
filter_labels,2025-02-28T19:42:04.731669,da663e46fbf02ec8a90b3f3c1079ef4c9f7907e1,5093,99,5192,4992
answer_question,2025-02-28T19:42:07.872122,da663e46fbf02ec8a90b3f3c1079ef4c9f7907e1,6170,84,6254,0
filter_labels,2025-02-28T19:42:09.201748,3bb894b4201667baf60b0b2c8a47109fa2357acb,882,49,931,0
answer_question,2025-02-28T19:42:10.327647,3bb894b4201667baf60b0b2c8a47109fa2357acb,1204,47,1251,0
filter_labels,2025-02-28T19:42:11.771043,da663e46fbf02ec8a90b3f3c1079ef4c9f7907e1,5097,57,5154,4992
answer_question,2025-02-28T19:42:13.532969,da663e46fbf02ec8a90b3f3c1079ef4c9f7907e1,2749,49,2798,0
answer_question,2025-02-28T19:42:34.643794,,871,107,978,0
filter_labels,2025-02-28T19:42:35.728768,67185fca2a09b3c46ee961b2c1ae160dab8b5231,1099,59,1158,1024
answer_question,2025-02-28T19:42:40.604257,67185fca2a09b3c46ee961b2c1ae160dab8b5231,948,45,993,0
answer_question,2025-02-28T19:43:07.407003,,867,103,970,0
filter_labels,2025-02-28T19:43:08.746177,a69ebee82a9acd54117407ca3697db0d7bfbfdac,3208,62,3270,0
answer_question,2025-02-28T19:43:11.769569,a69ebee82a9acd54117407ca3697db0d7bfbfdac,3846,80,3926,0
filter_labels,2025-02-28T19:43:13.868340,2db41ba86cc015db1f5f7de00b764a06e6de3dcc,2617,108,2725,0
answer_question,2025-02-28T19:43:20.169031,2db41ba86cc015db1f5f7de00b764a06e6de3dcc,12760,44,12804,0
filter_labels,2025-02-28T19:43:21.226121,c8af22dbedd95ee719273792e5964ab8bbba17b2,2448,54,2502,0
answer_question,2025-02-28T19:43:22.520435,c8af22dbedd95ee719273792e5964ab8bbba17b2,3265,33,3298,0
filter_labels,2025-02-28T19:43:23.745276,e229fc9f5c694e93b02ac312c231607a04e3e528,1863,54,1917,0
answer_question,2025-02-28T19:43:26.385835,e229fc9f5c694e93b02ac312c231607a04e3e528,3339,33,3372,0
filter_labels,2025-02-28T19:43:27.816760,23b2c590c4887dfb86761730dd7156fe3b216ab7,3049,65,3114,0
answer_question,2025-02-28T19:43:30.161389,23b2c590c4887dfb86761730dd7156fe3b216ab7,1671,54,1725,0
filter_labels,2025-02-28T19:43:31.716229,f879b3a802ccd6e8e6ca0a07ed8464318b7c0724,2353,71,2424,0
answer_question,2025-02-28T19:43:33.177488,f879b3a802ccd6e8e6ca0a07ed8464318b7c0724,2069,32,2101,0
filter_labels,2025-02-28T19:43:34.138917,c06d5ad4b6408fec26675d30b37a6042c007095a,1111,47,1158,0
answer_question,2025-02-28T19:43:36.348009,c06d5ad4b6408fec26675d30b37a6042c007095a,901,43,944,0
filter_labels,2025-02-28T19:43:37.241574,53a00624418f6c5c2d044344a4125bba7743614f,392,42,434,0
answer_question,2025-02-28T19:43:38.698110,53a00624418f6c5c2d044344a4125bba7743614f,617,38,655,0
filter_labels,2025-02-28T19:43:40.732168,3e5ccdb58faf901e75e31f154cb8330869ca5efa,952,83,1035,0
answer_question,2025-02-28T19:43:42.450477,3e5ccdb58faf901e75e31f154cb8330869ca5efa,3319,51,3370,0
filter_labels,2025-02-28T19:43:43.879875,553afbf09b6d83166b17acb02431c6cf38e4defc,845,58,903,0
answer_question,2025-02-28T19:43:45.404677,553afbf09b6d83166b17acb02431c6cf38e4defc,1632,53,1685,0
filter_labels,2025-02-28T19:43:47.005362,30f64d1043f4cb425eb636763580ae27094ffef1,1987,94,2081,0
answer_question,2025-02-28T19:43:51.383599,30f64d1043f4cb425eb636763580ae27094ffef1,5307,78,5385,0
filter_labels,2025-02-28T19:43:52.882462,105688726e097505beef4934896193ac51295037,1216,74,1290,0
answer_question,2025-02-28T19:43:54.660030,105688726e097505beef4934896193ac51295037,3423,43,3466,0
filter_labels,2025-02-28T19:43:59.546979,23b2c590c4887dfb86761730dd7156fe3b216ab7,3054,110,3164,0
answer_question,2025-02-28T19:44:04.809605,23b2c590c4887dfb86761730dd7156fe3b216ab7,10131,91,10222,0
filter_labels,2025-02-28T19:44:06.223519,105688726e097505beef4934896193ac51295037,1218,50,1268,0
answer_question,2025-02-28T19:44:07.871883,105688726e097505beef4934896193ac51295037,2480,45,2525,0
filter_labels,2025-02-28T19:44:08.910318,8f5e29eea4f4a3e944707c71148439ca1fd4b2d8,1175,56,1231,0
answer_question,2025-02-28T19:44:11.683010,8f5e29eea4f4a3e944707c71148439ca1fd4b2d8,2552,33,2585,0
filter_labels,2025-02-28T19:44:12.945267,e7a45fed0d7ebfd13a524e7fcc443318bac654e2,3930,61,3991,0
answer_question,2025-02-28T19:44:15.844674,e7a45fed0d7ebfd13a524e7fcc443318bac654e2,4368,67,4435,0
filter_labels,2025-02-28T19:44:17.635477,2db41ba86cc015db1f5f7de00b764a06e6de3dcc,2602,132,2734,0
answer_question,2025-02-28T19:44:22.032280,2db41ba86cc015db1f5f7de00b764a06e6de3dcc,5646,30,5676,0
filter_labels,2025-02-28T19:44:23.967054,9e794a58e511f6a6a9a13b201d652deff9f9f69a,6304,75,6379,0
answer_question,2025-02-28T19:44:29.514792,9e794a58e511f6a6a9a13b201d652deff9f9f69a,6475,52,6527,0
filter_labels,2025-02-28T19:44:31.363466,aa781901e117281bfee6f8e4bea6fc9c9bada62e,2367,109,2476,0
answer_question,2025-02-28T19:44:42.913700,aa781901e117281bfee6f8e4bea6fc9c9bada62e,20259,79,20338,0
filter_labels,2025-02-28T19:44:43.955442,a69ebee82a9acd54117407ca3697db0d7bfbfdac,3196,42,3238,0
labeling,2025-02-28T19:48:55.313791,a69ebee82a9acd54117407ca3697db0d7bfbfdac,20582,1487,22069,0
labeling,2025-02-28T19:49:05.921888,a69ebee82a9acd54117407ca3697db0d7bfbfdac,19938,383,20321,0
labeling,2025-02-28T19:49:41.590393,a69ebee82a9acd54117407ca3697db0d7bfbfdac,20384,491,20875,0
labeling,2025-02-28T19:50:21.528427,a69ebee82a9acd54117407ca3697db0d7bfbfdac,20233,602,20835,0
labeling,2025-02-28T19:50:56.444373,a69ebee82a9acd54117407ca3697db0d7bfbfdac,20633,553,21186,0
labeling,2025-02-28T19:51:40.759657,a69ebee82a9acd54117407ca3697db0d7bfbfdac,20788,340,21128,0
labeling,2025-02-28T19:51:43.437818,a69ebee82a9acd54117407ca3697db0d7bfbfdac,1866,94,1960,0
filter_labels,2025-02-28T19:52:25.978065,ecabab4934d4b80570c4bb3b8e35b7476694b3fb,1530,57,1587,1408
answer_question,2025-02-28T19:52:28.422188,ecabab4934d4b80570c4bb3b8e35b7476694b3fb,2331,47,2378,0
filter_labels,2025-02-28T19:52:29.858431,446545ae548543d8744f8d885ff75face3424ba4,631,84,715,0
answer_question,2025-02-28T19:52:33.763452,446545ae548543d8744f8d885ff75face3424ba4,10774,62,10836,0
filter_labels,2025-02-28T19:52:34.870723,9e794a58e511f6a6a9a13b201d652deff9f9f69a,6292,50,6342,6272
answer_question,2025-02-28T19:52:37.575363,9e794a58e511f6a6a9a13b201d652deff9f9f69a,5520,40,5560,0
filter_labels,2025-02-28T19:52:38.662290,92d9de8e4db96e0b95a484afcd1c54c6beb62c03,1056,52,1108,1024
answer_question,2025-02-28T19:52:39.784888,92d9de8e4db96e0b95a484afcd1c54c6beb62c03,1111,34,1145,0
filter_labels,2025-02-28T19:52:41.121945,ddd10e4612006205c4b1ba050a11648071e6e429,665,77,742,0
answer_question,2025-02-28T19:52:44.050892,ddd10e4612006205c4b1ba050a11648071e6e429,7163,65,7228,0
filter_labels,2025-02-28T19:52:45.609329,682de8e45fd9688f3452bc0e18257132a8f3cff6,1595,57,1652,1536
answer_question,2025-02-28T19:52:47.366297,682de8e45fd9688f3452bc0e18257132a8f3cff6,3036,36,3072,0
filter_labels,2025-02-28T19:52:50.019697,c74139ce26a6f803725f5074a8a0f539abb99c09,10669,63,10732,10624
filter_labels,2025-02-28T19:53:09.704986,ecabab4934d4b80570c4bb3b8e35b7476694b3fb,1530,56,1586,1408
answer_question,2025-02-28T19:53:13.210250,ecabab4934d4b80570c4bb3b8e35b7476694b3fb,2331,82,2413,0
filter_labels,2025-02-28T19:53:14.652708,446545ae548543d8744f8d885ff75face3424ba4,631,95,726,0
answer_question,2025-02-28T19:53:23.411532,446545ae548543d8744f8d885ff75face3424ba4,19682,70,19752,0
filter_labels,2025-02-28T19:53:24.634327,9e794a58e511f6a6a9a13b201d652deff9f9f69a,6292,65,6357,6272
answer_question,2025-02-28T19:53:29.138843,9e794a58e511f6a6a9a13b201d652deff9f9f69a,5520,89,5609,0
filter_labels,2025-02-28T19:53:30.211781,92d9de8e4db96e0b95a484afcd1c54c6beb62c03,1056,48,1104,1024
answer_question,2025-02-28T19:53:33.154942,92d9de8e4db96e0b95a484afcd1c54c6beb62c03,1111,71,1182,0
filter_labels,2025-02-28T19:53:35.032042,ddd10e4612006205c4b1ba050a11648071e6e429,665,123,788,0
answer_question,2025-02-28T19:54:03.832109,ddd10e4612006205c4b1ba050a11648071e6e429,21390,65,21455,0
filter_labels,2025-02-28T19:54:05.084588,682de8e45fd9688f3452bc0e18257132a8f3cff6,1595,67,1662,1536
answer_question,2025-02-28T19:54:10.208045,682de8e45fd9688f3452bc0e18257132a8f3cff6,3036,89,3125,0
filter_labels,2025-02-28T19:54:12.009318,c74139ce26a6f803725f5074a8a0f539abb99c09,10669,83,10752,10624
answer_question,2025-02-28T19:54:21.264116,c74139ce26a6f803725f5074a8a0f539abb99c09,3384,67,3451,0
filter_labels,2025-02-28T19:54:22.423343,e117005fc313bf0d49429d34bc8e1ef64de54898,1428,64,1492,1408
answer_question,2025-02-28T19:54:30.587173,e117005fc313bf0d49429d34bc8e1ef64de54898,3731,80,3811,0
filter_labels,2025-02-28T19:54:31.826994,553afbf09b6d83166b17acb02431c6cf38e4defc,842,65,907,0
answer_question,2025-02-28T19:54:36.939302,553afbf09b6d83166b17acb02431c6cf38e4defc,2263,101,2364,0
filter_labels,2025-02-28T19:54:38.505067,1af8f906e34af6e0acfe4f73e37093bbe34700f3,1626,115,1741,1536
answer_question,2025-02-28T19:54:42.612312,1af8f906e34af6e0acfe4f73e37093bbe34700f3,4491,77,4568,0
filter_labels,2025-02-28T19:54:44.062775,e30ece688caf7602b734bbbcf39559b4acdb2739,1734,87,1821,1664
answer_question,2025-02-28T19:54:48.113834,e30ece688caf7602b734bbbcf39559b4acdb2739,4937,81,5018,0
filter_labels,2025-02-28T19:54:49.495284,0a61a353b1ea9fd9b8f63b60239634ca3007d58f,2244,89,2333,2176
answer_question,2025-02-28T19:54:53.146464,0a61a353b1ea9fd9b8f63b60239634ca3007d58f,4331,78,4409,0
filter_labels,2025-02-28T19:54:55.143991,a85dba6c75031912d56a811637f803ba4ddeb257,1913,142,2055,1792
answer_question,2025-02-28T19:55:05.720520,a85dba6c75031912d56a811637f803ba4ddeb257,8398,92,8490,0
filter_labels,2025-02-28T19:55:09.184454,aa781901e117281bfee6f8e4bea6fc9c9bada62e,2350,56,2406,2304
answer_question,2025-02-28T19:55:12.282633,aa781901e117281bfee6f8e4bea6fc9c9bada62e,2898,72,2970,0
filter_labels,2025-02-28T19:55:14.055600,e30ece688caf7602b734bbbcf39559b4acdb2739,1716,108,1824,1664
answer_question,2025-02-28T19:55:19.841605,e30ece688caf7602b734bbbcf39559b4acdb2739,4919,72,4991,4864
filter_labels,2025-02-28T19:55:21.000547,36dd058d3237202cbb94139611c8b8a35ff8c158,878,71,949,0
answer_question,2025-02-28T19:55:28.062890,36dd058d3237202cbb94139611c8b8a35ff8c158,3324,69,3393,0
filter_labels,2025-02-28T19:55:29.482446,5a24fa827d172a7669eca206b2a5f47c2b19b48d,903,64,967,0
answer_question,2025-02-28T19:55:37.594537,5a24fa827d172a7669eca206b2a5f47c2b19b48d,4148,80,4228,0
filter_labels,2025-02-28T19:55:38.675979,6d76ccb75bbf1b27ca60b8419c5343ac050cebb0,1127,52,1179,1024
answer_question,2025-02-28T19:55:43.393751,6d76ccb75bbf1b27ca60b8419c5343ac050cebb0,1985,76,2061,0
filter_labels,2025-02-28T19:55:45.191345,e117005fc313bf0d49429d34bc8e1ef64de54898,1435,105,1540,1408
filter_labels,2025-02-28T19:56:56.955595,ecabab4934d4b80570c4bb3b8e35b7476694b3fb,1530,55,1585,1408
answer_question,2025-02-28T19:57:00.913221,ecabab4934d4b80570c4bb3b8e35b7476694b3fb,2331,93,2424,2304
filter_labels,2025-02-28T19:57:02.593592,446545ae548543d8744f8d885ff75face3424ba4,631,100,731,0
answer_question,2025-02-28T19:57:09.375315,446545ae548543d8744f8d885ff75face3424ba4,16292,70,16362,0
filter_labels,2025-02-28T19:57:11.000724,9e794a58e511f6a6a9a13b201d652deff9f9f69a,6292,62,6354,6272
answer_question,2025-02-28T19:57:15.148483,9e794a58e511f6a6a9a13b201d652deff9f9f69a,5520,89,5609,5504
filter_labels,2025-02-28T19:57:16.479518,92d9de8e4db96e0b95a484afcd1c54c6beb62c03,1056,49,1105,1024
answer_question,2025-02-28T19:57:19.554111,92d9de8e4db96e0b95a484afcd1c54c6beb62c03,1111,71,1182,1024
filter_labels,2025-02-28T19:57:20.863939,ddd10e4612006205c4b1ba050a11648071e6e429,665,57,722,0
answer_question,2025-02-28T19:57:24.156517,ddd10e4612006205c4b1ba050a11648071e6e429,2749,65,2814,0
filter_labels,2025-02-28T19:57:25.707870,682de8e45fd9688f3452bc0e18257132a8f3cff6,1595,51,1646,1536
answer_question,2025-02-28T19:57:29.810368,682de8e45fd9688f3452bc0e18257132a8f3cff6,3036,89,3125,2944
filter_labels,2025-02-28T19:57:31.771072,c74139ce26a6f803725f5074a8a0f539abb99c09,10669,72,10741,10624
answer_question,2025-02-28T19:57:39.055980,c74139ce26a6f803725f5074a8a0f539abb99c09,3384,67,3451,3328
filter_labels,2025-02-28T19:57:40.640488,e117005fc313bf0d49429d34bc8e1ef64de54898,1428,88,1516,1408
answer_question,2025-02-28T19:57:45.534335,e117005fc313bf0d49429d34bc8e1ef64de54898,3731,66,3797,3712
filter_labels,2025-02-28T19:57:46.867593,553afbf09b6d83166b17acb02431c6cf38e4defc,842,82,924,0
answer_question,2025-02-28T19:57:50.987055,553afbf09b6d83166b17acb02431c6cf38e4defc,2263,71,2334,2176
filter_labels,2025-02-28T19:57:52.350753,1af8f906e34af6e0acfe4f73e37093bbe34700f3,1626,76,1702,1536
answer_question,2025-02-28T19:57:56.210782,1af8f906e34af6e0acfe4f73e37093bbe34700f3,6826,77,6903,0
filter_labels,2025-02-28T19:57:58.052680,e30ece688caf7602b734bbbcf39559b4acdb2739,1734,74,1808,1664
answer_question,2025-02-28T19:58:01.230020,e30ece688caf7602b734bbbcf39559b4acdb2739,4039,81,4120,0
filter_labels,2025-02-28T19:58:02.743979,0a61a353b1ea9fd9b8f63b60239634ca3007d58f,2244,67,2311,2176
answer_question,2025-02-28T19:58:05.767129,0a61a353b1ea9fd9b8f63b60239634ca3007d58f,1789,78,1867,0
filter_labels,2025-02-28T19:58:07.170762,a85dba6c75031912d56a811637f803ba4ddeb257,1913,87,2000,1792
answer_question,2025-02-28T19:58:10.839989,a85dba6c75031912d56a811637f803ba4ddeb257,8398,92,8490,8320
filter_labels,2025-02-28T19:58:12.318965,aa781901e117281bfee6f8e4bea6fc9c9bada62e,2350,80,2430,2304
answer_question,2025-02-28T19:58:16.183796,aa781901e117281bfee6f8e4bea6fc9c9bada62e,2898,64,2962,2816
filter_labels,2025-02-28T19:58:17.300717,e30ece688caf7602b734bbbcf39559b4acdb2739,1716,63,1779,1664
answer_question,2025-02-28T19:58:24.881565,e30ece688caf7602b734bbbcf39559b4acdb2739,4919,64,4983,4864
filter_labels,2025-02-28T19:58:25.893759,36dd058d3237202cbb94139611c8b8a35ff8c158,878,54,932,0
answer_question,2025-02-28T19:58:32.474393,36dd058d3237202cbb94139611c8b8a35ff8c158,3324,69,3393,3200
filter_labels,2025-02-28T19:58:33.598851,5a24fa827d172a7669eca206b2a5f47c2b19b48d,903,56,959,0
answer_question,2025-02-28T19:58:41.729737,5a24fa827d172a7669eca206b2a5f47c2b19b48d,4148,80,4228,0
filter_labels,2025-02-28T19:58:42.902467,6d76ccb75bbf1b27ca60b8419c5343ac050cebb0,1127,67,1194,1024
answer_question,2025-02-28T19:58:46.243023,6d76ccb75bbf1b27ca60b8419c5343ac050cebb0,3105,68,3173,0
filter_labels,2025-02-28T19:58:48.125851,e117005fc313bf0d49429d34bc8e1ef64de54898,1435,128,1563,1408
filter_labels,2025-02-28T20:01:10.905863,ecabab4934d4b80570c4bb3b8e35b7476694b3fb,1530,53,1583,1408
answer_question,2025-02-28T20:01:13.057963,ecabab4934d4b80570c4bb3b8e35b7476694b3fb,2331,47,2378,2304
filter_labels,2025-02-28T20:01:14.518621,446545ae548543d8744f8d885ff75face3424ba4,631,74,705,0
answer_question,2025-02-28T20:01:17.677401,446545ae548543d8744f8d885ff75face3424ba4,9539,62,9601,0
filter_labels,2025-02-28T20:01:18.971028,9e794a58e511f6a6a9a13b201d652deff9f9f69a,6292,67,6359,6272
answer_question,2025-02-28T20:01:21.846719,9e794a58e511f6a6a9a13b201d652deff9f9f69a,5520,40,5560,5504
filter_labels,2025-02-28T20:01:23.059538,92d9de8e4db96e0b95a484afcd1c54c6beb62c03,1056,52,1108,0
answer_question,2025-02-28T20:01:25.685208,92d9de8e4db96e0b95a484afcd1c54c6beb62c03,1111,34,1145,1024
filter_labels,2025-02-28T20:01:27.348517,ddd10e4612006205c4b1ba050a11648071e6e429,665,114,779,0
answer_question,2025-02-28T20:01:36.930519,ddd10e4612006205c4b1ba050a11648071e6e429,22361,65,22426,0
filter_labels,2025-02-28T20:01:38.111412,682de8e45fd9688f3452bc0e18257132a8f3cff6,1595,61,1656,1536
answer_question,2025-02-28T20:01:40.090781,682de8e45fd9688f3452bc0e18257132a8f3cff6,3036,55,3091,2944
filter_labels,2025-02-28T20:01:42.167195,c74139ce26a6f803725f5074a8a0f539abb99c09,10669,72,10741,10624
answer_question,2025-02-28T20:01:47.533225,c74139ce26a6f803725f5074a8a0f539abb99c09,3384,33,3417,0
filter_labels,2025-02-28T20:01:49.381340,e117005fc313bf0d49429d34bc8e1ef64de54898,1428,83,1511,1408
answer_question,2025-02-28T20:01:53.164806,e117005fc313bf0d49429d34bc8e1ef64de54898,3731,34,3765,0
filter_labels,2025-02-28T20:01:54.459824,553afbf09b6d83166b17acb02431c6cf38e4defc,842,67,909,0
answer_question,2025-02-28T20:01:56.755119,553afbf09b6d83166b17acb02431c6cf38e4defc,2263,50,2313,0
filter_labels,2025-02-28T20:01:58.905872,1af8f906e34af6e0acfe4f73e37093bbe34700f3,1626,110,1736,1536
answer_question,2025-02-28T20:02:02.015169,1af8f906e34af6e0acfe4f73e37093bbe34700f3,6721,69,6790,0
filter_labels,2025-02-28T20:02:03.867053,e30ece688caf7602b734bbbcf39559b4acdb2739,1734,103,1837,1664
answer_question,2025-02-28T20:02:05.814097,e30ece688caf7602b734bbbcf39559b4acdb2739,4937,39,4976,0
filter_labels,2025-02-28T20:02:07.160447,0a61a353b1ea9fd9b8f63b60239634ca3007d58f,2244,85,2329,2176
answer_question,2025-02-28T20:02:09.288004,0a61a353b1ea9fd9b8f63b60239634ca3007d58f,2042,70,2112,0
filter_labels,2025-02-28T20:02:10.659476,a85dba6c75031912d56a811637f803ba4ddeb257,1913,84,1997,1792
answer_question,2025-02-28T20:02:12.962569,a85dba6c75031912d56a811637f803ba4ddeb257,6996,49,7045,0
filter_labels,2025-02-28T20:02:14.362525,aa781901e117281bfee6f8e4bea6fc9c9bada62e,2350,78,2428,2304
answer_question,2025-02-28T20:02:16.494820,aa781901e117281bfee6f8e4bea6fc9c9bada62e,2898,72,2970,0
filter_labels,2025-02-28T20:02:17.907378,e30ece688caf7602b734bbbcf39559b4acdb2739,1716,72,1788,1664
answer_question,2025-02-28T20:02:19.991996,e30ece688caf7602b734bbbcf39559b4acdb2739,4919,33,4952,0
filter_labels,2025-02-28T20:02:21.888089,36dd058d3237202cbb94139611c8b8a35ff8c158,878,95,973,0
answer_question,2025-02-28T20:02:28.184755,36dd058d3237202cbb94139611c8b8a35ff8c158,3324,36,3360,0
filter_labels,2025-02-28T20:02:29.414874,5a24fa827d172a7669eca206b2a5f47c2b19b48d,903,64,967,0
answer_question,2025-02-28T20:02:31.862857,5a24fa827d172a7669eca206b2a5f47c2b19b48d,4148,72,4220,0
filter_labels,2025-02-28T20:02:33.088509,6d76ccb75bbf1b27ca60b8419c5343ac050cebb0,1127,61,1188,1024
answer_question,2025-02-28T20:02:35.667623,6d76ccb75bbf1b27ca60b8419c5343ac050cebb0,1985,68,2053,0
filter_labels,2025-02-28T20:02:37.593838,e117005fc313bf0d49429d34bc8e1ef64de54898,1435,127,1562,1408
answer_question,2025-02-28T20:02:41.782048,e117005fc313bf0d49429d34bc8e1ef64de54898,8838,44,8882,0
filter_labels,2025-02-28T20:02:42.933635,c7475e1d98f9a46a4652e503881d4a67232b41d3,1956,53,2009,1920
answer_question,2025-02-28T20:02:44.682027,c7475e1d98f9a46a4652e503881d4a67232b41d3,2745,37,2782,0
filter_labels,2025-02-28T20:02:46.008969,4d3e52b69b4b5366e54ce87cf641b01b1419bdee,2043,76,2119,1920
answer_question,2025-02-28T20:02:48.934325,4d3e52b69b4b5366e54ce87cf641b01b1419bdee,5997,47,6044,0
filter_labels,2025-02-28T20:02:54.437110,13999998018cc53440310d94a26d1e8957e2277f,2010,95,2105,1920
answer_question,2025-02-28T20:03:03.730661,13999998018cc53440310d94a26d1e8957e2277f,21709,46,21755,0
answer_question,2025-02-28T20:03:18.008538,,869,110,979,0
filter_labels,2025-02-28T20:03:19.949258,0a61a353b1ea9fd9b8f63b60239634ca3007d58f,2250,134,2384,2176
answer_question,2025-02-28T20:03:26.862340,0a61a353b1ea9fd9b8f63b60239634ca3007d58f,21825,75,21900,0
answer_question,2025-02-28T20:03:52.354538,,932,68,1000,0
filter_labels,2025-02-28T20:03:53.479857,f879b3a802ccd6e8e6ca0a07ed8464318b7c0724,2368,67,2435,2304
answer_question,2025-02-28T20:03:54.918699,f879b3a802ccd6e8e6ca0a07ed8464318b7c0724,1241,46,1287,0
filter_labels,2025-02-28T20:03:55.939251,74c690176ce433301f4d1e808bb002a2f4dc321a,1279,60,1339,1152
answer_question,2025-02-28T20:03:57.887599,74c690176ce433301f4d1e808bb002a2f4dc321a,1138,47,1185,0
filter_labels,2025-02-28T20:03:59.217789,f015d4bfeec43fe65c003b6f4420ae864efbb58f,1081,69,1150,1024
answer_question,2025-02-28T20:04:01.158942,f015d4bfeec43fe65c003b6f4420ae864efbb58f,3145,43,3188,0
filter_labels,2025-02-28T20:04:02.712750,a69ebee82a9acd54117407ca3697db0d7bfbfdac,4986,82,5068,0
answer_question,2025-02-28T20:04:05.414216,a69ebee82a9acd54117407ca3697db0d7bfbfdac,5896,44,5940,0
filter_labels,2025-02-28T20:04:06.302087,980742aa08ea64d552c153bcefbd7e8243fb9efd,1264,43,1307,1152
answer_question,2025-02-28T20:04:07.645054,980742aa08ea64d552c153bcefbd7e8243fb9efd,1320,31,1351,0
filter_labels,2025-02-28T20:04:08.609301,6529fba868216a923407fb0d4e15a811a8e89ebc,1382,57,1439,1280
answer_question,2025-02-28T20:04:10.345439,6529fba868216a923407fb0d4e15a811a8e89ebc,575,33,608,0
filter_labels,2025-02-28T20:04:11.661838,e30ece688caf7602b734bbbcf39559b4acdb2739,1729,87,1816,1664
answer_question,2025-02-28T20:04:13.894118,e30ece688caf7602b734bbbcf39559b4acdb2739,4932,45,4977,0
filter_labels,2025-02-28T20:04:14.889272,b947c33b370d8a3251ef9c36ce7d71e8d16f4f8e,1798,43,1841,1792
answer_question,2025-02-28T20:04:16.381663,b947c33b370d8a3251ef9c36ce7d71e8d16f4f8e,1758,58,1816,0
filter_labels,2025-02-28T20:04:17.575704,6529fba868216a923407fb0d4e15a811a8e89ebc,1384,56,1440,1280
answer_question,2025-02-28T20:04:19.392241,6529fba868216a923407fb0d4e15a811a8e89ebc,989,35,1024,0
filter_labels,2025-02-28T20:04:20.294732,c06d5ad4b6408fec26675d30b37a6042c007095a,1106,40,1146,1024
answer_question,2025-02-28T20:04:22.879143,c06d5ad4b6408fec26675d30b37a6042c007095a,2008,69,2077,0
filter_labels,2025-02-28T20:04:23.813128,4e3efdc544140b872a59e124443a64c34f356911,798,51,849,0
answer_question,2025-02-28T20:04:29.287728,4e3efdc544140b872a59e124443a64c34f356911,2038,68,2106,0
filter_labels,2025-02-28T20:04:30.409062,aa781901e117281bfee6f8e4bea6fc9c9bada62e,2374,64,2438,2304
answer_question,2025-02-28T20:04:33.726860,aa781901e117281bfee6f8e4bea6fc9c9bada62e,5991,87,6078,0
filter_labels,2025-02-28T20:04:34.960223,105688726e097505beef4934896193ac51295037,1218,72,1290,1152
answer_question,2025-02-28T20:04:37.432057,105688726e097505beef4934896193ac51295037,4864,45,4909,0
filter_labels,2025-02-28T20:04:38.482503,1a12ef3f11a64e92eeca39e493a17d2860c014a6,3000,46,3046,2944
answer_question,2025-02-28T20:04:40.202941,1a12ef3f11a64e92eeca39e493a17d2860c014a6,1630,54,1684,0
filter_labels,2025-02-28T20:04:43.740871,aa781901e117281bfee6f8e4bea6fc9c9bada62e,2348,70,2418,2304
answer_question,2025-02-28T20:04:45.205876,aa781901e117281bfee6f8e4bea6fc9c9bada62e,2950,28,2978,0
filter_labels,2025-02-28T20:04:46.198327,d14ae2b6284e48b5c1e6659a0a5863d84697b3b9,1121,48,1169,1024
answer_question,2025-02-28T20:04:47.709413,d14ae2b6284e48b5c1e6659a0a5863d84697b3b9,1251,38,1289,0
answer_question,2025-02-28T20:05:09.279416,,876,104,980,0
filter_labels,2025-02-28T20:05:10.490758,35839effbc332f23d5f34263aab3dcb2c6976420,1180,64,1244,1152
answer_question,2025-02-28T20:05:13.148921,35839effbc332f23d5f34263aab3dcb2c6976420,5422,35,5457,0
filter_labels,2025-02-28T20:05:14.383956,78c71282723c2d66216cbba13183d19349d302b8,3049,52,3101,2944
answer_question,2025-02-28T20:05:16.993443,78c71282723c2d66216cbba13183d19349d302b8,1934,89,2023,0
filter_labels,2025-02-28T20:05:18.271346,da663e46fbf02ec8a90b3f3c1079ef4c9f7907e1,5075,69,5144,4992
answer_question,2025-02-28T20:05:19.991990,da663e46fbf02ec8a90b3f3c1079ef4c9f7907e1,1610,37,1647,0
filter_labels,2025-02-28T20:05:21.039283,682de8e45fd9688f3452bc0e18257132a8f3cff6,1584,49,1633,1536
answer_question,2025-02-28T20:05:22.981808,682de8e45fd9688f3452bc0e18257132a8f3cff6,2609,45,2654,0
filter_labels,2025-02-28T20:05:25.162127,0279901b645e568591ad95dac2c2bf939ef0c00d,3322,146,3468,3200
answer_question,2025-02-28T20:05:28.305479,0279901b645e568591ad95dac2c2bf939ef0c00d,6067,66,6133,0
filter_labels,2025-02-28T20:05:30.097734,74c690176ce433301f4d1e808bb002a2f4dc321a,1277,81,1358,1152
answer_question,2025-02-28T20:05:32.364240,74c690176ce433301f4d1e808bb002a2f4dc321a,2621,45,2666,0
filter_labels,2025-02-28T20:05:33.640576,30f64d1043f4cb425eb636763580ae27094ffef1,2005,62,2067,1920
answer_question,2025-02-28T20:05:37.137304,30f64d1043f4cb425eb636763580ae27094ffef1,3764,53,3817,0
filter_labels,2025-02-28T20:05:39.117332,74c690176ce433301f4d1e808bb002a2f4dc321a,1273,76,1349,1152
answer_question,2025-02-28T20:05:41.416729,74c690176ce433301f4d1e808bb002a2f4dc321a,3963,38,4001,0
filter_labels,2025-02-28T20:05:42.852221,3f36d4f26ada778d89cf5a7344be0b9e9a5223a3,1396,98,1494,1280
answer_question,2025-02-28T20:05:47.049272,3f36d4f26ada778d89cf5a7344be0b9e9a5223a3,8167,88,8255,0
filter_labels,2025-02-28T20:05:48.673774,78c71282723c2d66216cbba13183d19349d302b8,3026,92,3118,2944
answer_question,2025-02-28T20:05:51.154973,78c71282723c2d66216cbba13183d19349d302b8,4039,66,4105,0
filter_labels,2025-02-28T20:05:52.326624,696ddc4c80febe0f1559ed3b1272487c74ca91cc,1365,68,1433,1280
answer_question,2025-02-28T20:05:54.516812,696ddc4c80febe0f1559ed3b1272487c74ca91cc,794,37,831,0
answer_question,2025-02-28T20:06:15.146117,,887,111,998,0
filter_labels,2025-02-28T20:06:16.753130,a69ebee82a9acd54117407ca3697db0d7bfbfdac,4986,76,5062,0
answer_question,2025-02-28T20:06:19.830192,a69ebee82a9acd54117407ca3697db0d7bfbfdac,6640,48,6688,0
filter_labels,2025-02-28T20:06:21.467034,cc0fc5888b99758100a7ff024863fc4337b6b3c5,6017,68,6085,5888
answer_question,2025-02-28T20:06:25.035496,cc0fc5888b99758100a7ff024863fc4337b6b3c5,10072,45,10117,0
answer_question,2025-02-28T20:06:45.043089,,929,108,1037,0
filter_labels,2025-02-28T20:06:46.807841,da663e46fbf02ec8a90b3f3c1079ef4c9f7907e1,5093,91,5184,4992
answer_question,2025-02-28T20:06:50.434478,da663e46fbf02ec8a90b3f3c1079ef4c9f7907e1,6170,84,6254,0
filter_labels,2025-02-28T20:06:51.775718,3bb894b4201667baf60b0b2c8a47109fa2357acb,882,78,960,0
answer_question,2025-02-28T20:06:52.770610,3bb894b4201667baf60b0b2c8a47109fa2357acb,1204,36,1240,0
filter_labels,2025-02-28T20:06:54.265585,da663e46fbf02ec8a90b3f3c1079ef4c9f7907e1,5097,79,5176,4992
answer_question,2025-02-28T20:06:55.944212,da663e46fbf02ec8a90b3f3c1079ef4c9f7907e1,596,49,645,0
answer_question,2025-02-28T20:07:12.481764,,876,107,983,0
filter_labels,2025-02-28T20:07:13.672666,67185fca2a09b3c46ee961b2c1ae160dab8b5231,1099,63,1162,0
answer_question,2025-02-28T20:07:18.755094,67185fca2a09b3c46ee961b2c1ae160dab8b5231,948,46,994,0
answer_question,2025-02-28T20:07:38.225126,,878,81,959,0
filter_labels,2025-02-28T20:07:40.253074,a69ebee82a9acd54117407ca3697db0d7bfbfdac,4985,80,5065,0
answer_question,2025-02-28T20:07:42.762080,a69ebee82a9acd54117407ca3697db0d7bfbfdac,4216,47,4263,0
filter_labels,2025-02-28T20:07:43.872839,2db41ba86cc015db1f5f7de00b764a06e6de3dcc,2617,47,2664,2560
answer_question,2025-02-28T20:07:47.265856,2db41ba86cc015db1f5f7de00b764a06e6de3dcc,4686,45,4731,0
filter_labels,2025-02-28T20:07:48.590371,c8af22dbedd95ee719273792e5964ab8bbba17b2,2448,72,2520,2432
answer_question,2025-02-28T20:07:52.739431,c8af22dbedd95ee719273792e5964ab8bbba17b2,3265,33,3298,0
filter_labels,2025-02-28T20:07:54.016553,e229fc9f5c694e93b02ac312c231607a04e3e528,1863,70,1933,1792
answer_question,2025-02-28T20:07:56.996344,e229fc9f5c694e93b02ac312c231607a04e3e528,3057,67,3124,0
filter_labels,2025-02-28T20:07:58.527842,23b2c590c4887dfb86761730dd7156fe3b216ab7,3049,68,3117,2944
answer_question,2025-02-28T20:08:00.991276,23b2c590c4887dfb86761730dd7156fe3b216ab7,1671,54,1725,0
filter_labels,2025-02-28T20:08:02.804898,f879b3a802ccd6e8e6ca0a07ed8464318b7c0724,2353,113,2466,2304
answer_question,2025-02-28T20:08:05.165671,f879b3a802ccd6e8e6ca0a07ed8464318b7c0724,3019,68,3087,0
filter_labels,2025-02-28T20:08:06.366421,c06d5ad4b6408fec26675d30b37a6042c007095a,1111,39,1150,1024
answer_question,2025-02-28T20:08:08.157323,c06d5ad4b6408fec26675d30b37a6042c007095a,901,43,944,0
filter_labels,2025-02-28T20:08:09.147297,53a00624418f6c5c2d044344a4125bba7743614f,392,45,437,0
answer_question,2025-02-28T20:08:10.511731,53a00624418f6c5c2d044344a4125bba7743614f,617,38,655,0
filter_labels,2025-02-28T20:08:11.743515,3e5ccdb58faf901e75e31f154cb8330869ca5efa,952,77,1029,0
answer_question,2025-02-28T20:08:13.289995,3e5ccdb58faf901e75e31f154cb8330869ca5efa,3319,51,3370,0
filter_labels,2025-02-28T20:08:15.094341,553afbf09b6d83166b17acb02431c6cf38e4defc,845,69,914,0
answer_question,2025-02-28T20:08:16.478611,553afbf09b6d83166b17acb02431c6cf38e4defc,1632,53,1685,0
filter_labels,2025-02-28T20:08:17.680215,30f64d1043f4cb425eb636763580ae27094ffef1,1987,73,2060,1920
answer_question,2025-02-28T20:08:22.013353,30f64d1043f4cb425eb636763580ae27094ffef1,5307,78,5385,0
filter_labels,2025-02-28T20:08:23.640781,105688726e097505beef4934896193ac51295037,1216,76,1292,1152
answer_question,2025-02-28T20:08:25.387476,105688726e097505beef4934896193ac51295037,3423,43,3466,0
filter_labels,2025-02-28T20:08:26.747237,23b2c590c4887dfb86761730dd7156fe3b216ab7,3054,89,3143,2944
answer_question,2025-02-28T20:08:30.173379,23b2c590c4887dfb86761730dd7156fe3b216ab7,3822,58,3880,0
filter_labels,2025-02-28T20:08:31.851915,105688726e097505beef4934896193ac51295037,1218,59,1277,1152
answer_question,2025-02-28T20:08:33.330843,105688726e097505beef4934896193ac51295037,2480,45,2525,0
filter_labels,2025-02-28T20:08:34.631589,8f5e29eea4f4a3e944707c71148439ca1fd4b2d8,1175,55,1230,1152
answer_question,2025-02-28T20:08:37.114112,8f5e29eea4f4a3e944707c71148439ca1fd4b2d8,2552,33,2585,0
filter_labels,2025-02-28T20:08:38.485718,e7a45fed0d7ebfd13a524e7fcc443318bac654e2,3930,79,4009,3840
answer_question,2025-02-28T20:08:42.440067,e7a45fed0d7ebfd13a524e7fcc443318bac654e2,4368,67,4435,0
filter_labels,2025-02-28T20:08:43.798528,2db41ba86cc015db1f5f7de00b764a06e6de3dcc,2602,79,2681,2560
answer_question,2025-02-28T20:08:47.373031,2db41ba86cc015db1f5f7de00b764a06e6de3dcc,3851,30,3881,0
filter_labels,2025-02-28T20:08:48.841855,9e794a58e511f6a6a9a13b201d652deff9f9f69a,6304,68,6372,6272
answer_question,2025-02-28T20:08:53.519247,9e794a58e511f6a6a9a13b201d652deff9f9f69a,6475,52,6527,0
filter_labels,2025-02-28T20:08:55.525669,aa781901e117281bfee6f8e4bea6fc9c9bada62e,2367,96,2463,2304
answer_question,2025-02-28T20:09:05.927534,aa781901e117281bfee6f8e4bea6fc9c9bada62e,20259,79,20338,0
filter_labels,2025-02-28T20:09:07.958961,a69ebee82a9acd54117407ca3697db0d7bfbfdac,4973,67,5040,0
filter_labels,2025-02-28T20:16:37.798989,ecabab4934d4b80570c4bb3b8e35b7476694b3fb,1530,64,1594,1408
answer_question,2025-02-28T20:16:40.079609,ecabab4934d4b80570c4bb3b8e35b7476694b3fb,2331,47,2378,0
filter_labels,2025-02-28T20:16:41.487437,446545ae548543d8744f8d885ff75face3424ba4,631,79,710,0
answer_question,2025-02-28T20:16:45.275663,446545ae548543d8744f8d885ff75face3424ba4,11412,32,11444,0
filter_labels,2025-02-28T20:16:47.176298,9e794a58e511f6a6a9a13b201d652deff9f9f69a,6292,95,6387,6272
answer_question,2025-02-28T20:16:49.784928,9e794a58e511f6a6a9a13b201d652deff9f9f69a,5520,40,5560,0
filter_labels,2025-02-28T20:16:50.841603,92d9de8e4db96e0b95a484afcd1c54c6beb62c03,1056,45,1101,1024
answer_question,2025-02-28T20:16:52.040825,92d9de8e4db96e0b95a484afcd1c54c6beb62c03,1111,34,1145,0
filter_labels,2025-02-28T20:16:53.730322,ddd10e4612006205c4b1ba050a11648071e6e429,665,128,793,0
answer_question,2025-02-28T20:17:02.211593,ddd10e4612006205c4b1ba050a11648071e6e429,21390,65,21455,0
filter_labels,2025-02-28T20:17:03.916932,682de8e45fd9688f3452bc0e18257132a8f3cff6,1595,58,1653,1536
answer_question,2025-02-28T20:17:05.806083,682de8e45fd9688f3452bc0e18257132a8f3cff6,3036,55,3091,0
filter_labels,2025-02-28T20:17:07.300029,c74139ce26a6f803725f5074a8a0f539abb99c09,10669,70,10739,10624
answer_question,2025-02-28T20:17:12.835437,c74139ce26a6f803725f5074a8a0f539abb99c09,3384,33,3417,0
filter_labels,2025-02-28T20:17:13.797766,e117005fc313bf0d49429d34bc8e1ef64de54898,1428,61,1489,1408
answer_question,2025-02-28T20:17:17.157387,e117005fc313bf0d49429d34bc8e1ef64de54898,3731,34,3765,0
filter_labels,2025-02-28T20:17:18.232149,553afbf09b6d83166b17acb02431c6cf38e4defc,842,67,909,0
answer_question,2025-02-28T20:17:20.404171,553afbf09b6d83166b17acb02431c6cf38e4defc,2263,50,2313,0
filter_labels,2025-02-28T20:17:21.736474,1af8f906e34af6e0acfe4f73e37093bbe34700f3,1626,86,1712,1536
answer_question,2025-02-28T20:17:23.070420,1af8f906e34af6e0acfe4f73e37093bbe34700f3,3457,34,3491,0
filter_labels,2025-02-28T20:17:24.383153,e30ece688caf7602b734bbbcf39559b4acdb2739,1734,99,1833,1664
answer_question,2025-02-28T20:17:26.940488,e30ece688caf7602b734bbbcf39559b4acdb2739,4937,50,4987,0
filter_labels,2025-02-28T20:17:28.391234,0a61a353b1ea9fd9b8f63b60239634ca3007d58f,2244,76,2320,2176
answer_question,2025-02-28T20:17:30.909637,0a61a353b1ea9fd9b8f63b60239634ca3007d58f,4331,70,4401,0
filter_labels,2025-02-28T20:17:32.523932,a85dba6c75031912d56a811637f803ba4ddeb257,1913,115,2028,1792
answer_question,2025-02-28T20:17:34.154348,a85dba6c75031912d56a811637f803ba4ddeb257,3471,49,3520,0
filter_labels,2025-02-28T20:17:35.251707,aa781901e117281bfee6f8e4bea6fc9c9bada62e,2350,55,2405,2304
answer_question,2025-02-28T20:17:37.340444,aa781901e117281bfee6f8e4bea6fc9c9bada62e,2898,64,2962,0
filter_labels,2025-02-28T20:17:38.783141,e30ece688caf7602b734bbbcf39559b4acdb2739,1716,86,1802,1664
answer_question,2025-02-28T20:17:40.990336,e30ece688caf7602b734bbbcf39559b4acdb2739,6575,64,6639,0
filter_labels,2025-02-28T20:17:42.274884,36dd058d3237202cbb94139611c8b8a35ff8c158,878,72,950,0
answer_question,2025-02-28T20:17:44.105700,36dd058d3237202cbb94139611c8b8a35ff8c158,3324,36,3360,0
filter_labels,2025-02-28T20:17:45.869800,5a24fa827d172a7669eca206b2a5f47c2b19b48d,903,63,966,0
answer_question,2025-02-28T20:17:48.740709,5a24fa827d172a7669eca206b2a5f47c2b19b48d,4148,72,4220,0
filter_labels,2025-02-28T20:17:49.944456,6d76ccb75bbf1b27ca60b8419c5343ac050cebb0,1127,71,1198,1024
answer_question,2025-02-28T20:17:52.607777,6d76ccb75bbf1b27ca60b8419c5343ac050cebb0,3674,68,3742,0
filter_labels,2025-02-28T20:17:54.443206,e117005fc313bf0d49429d34bc8e1ef64de54898,1435,107,1542,1408
answer_question,2025-02-28T20:17:58.327446,e117005fc313bf0d49429d34bc8e1ef64de54898,8838,44,8882,0
filter_labels,2025-02-28T20:17:59.578156,c7475e1d98f9a46a4652e503881d4a67232b41d3,1956,79,2035,1920
answer_question,2025-02-28T20:18:01.260791,c7475e1d98f9a46a4652e503881d4a67232b41d3,1736,37,1773,0
filter_labels,2025-02-28T20:18:02.537046,4d3e52b69b4b5366e54ce87cf641b01b1419bdee,2043,75,2118,1920
answer_question,2025-02-28T20:18:05.309123,4d3e52b69b4b5366e54ce87cf641b01b1419bdee,5997,47,6044,0
filter_labels,2025-02-28T20:18:07.148167,13999998018cc53440310d94a26d1e8957e2277f,2010,120,2130,1920
answer_question,2025-02-28T20:18:15.221991,13999998018cc53440310d94a26d1e8957e2277f,25157,46,25203,0
answer_question,2025-02-28T20:18:29.678696,,868,85,953,0
filter_labels,2025-02-28T20:18:31.409656,0a61a353b1ea9fd9b8f63b60239634ca3007d58f,2250,122,2372,2176
answer_question,2025-02-28T20:18:37.511810,0a61a353b1ea9fd9b8f63b60239634ca3007d58f,20657,39,20696,0
answer_question,2025-02-28T20:18:59.480089,,875,103,978,0
filter_labels,2025-02-28T20:19:00.551254,f879b3a802ccd6e8e6ca0a07ed8464318b7c0724,2368,54,2422,2304
answer_question,2025-02-28T20:19:01.817457,f879b3a802ccd6e8e6ca0a07ed8464318b7c0724,1241,46,1287,0
filter_labels,2025-02-28T20:19:02.991520,74c690176ce433301f4d1e808bb002a2f4dc321a,1279,44,1323,1152
answer_question,2025-02-28T20:19:04.851893,74c690176ce433301f4d1e808bb002a2f4dc321a,1138,47,1185,0
filter_labels,2025-02-28T20:19:06.632218,f015d4bfeec43fe65c003b6f4420ae864efbb58f,1081,88,1169,1024
answer_question,2025-02-28T20:19:08.281951,f015d4bfeec43fe65c003b6f4420ae864efbb58f,3145,43,3188,0
filter_labels,2025-02-28T20:19:09.977747,a69ebee82a9acd54117407ca3697db0d7bfbfdac,4986,83,5069,3072
answer_question,2025-02-28T20:19:13.078883,a69ebee82a9acd54117407ca3697db0d7bfbfdac,5896,83,5979,0
filter_labels,2025-02-28T20:19:14.170110,980742aa08ea64d552c153bcefbd7e8243fb9efd,1264,68,1332,1152
answer_question,2025-02-28T20:19:15.771682,980742aa08ea64d552c153bcefbd7e8243fb9efd,3116,31,3147,0
filter_labels,2025-02-28T20:19:17.066965,6529fba868216a923407fb0d4e15a811a8e89ebc,1382,78,1460,1280
answer_question,2025-02-28T20:19:26.937255,6529fba868216a923407fb0d4e15a811a8e89ebc,7906,67,7973,0
filter_labels,2025-02-28T20:19:28.786273,e30ece688caf7602b734bbbcf39559b4acdb2739,1729,107,1836,1664
answer_question,2025-02-28T20:19:30.965340,e30ece688caf7602b734bbbcf39559b4acdb2739,4932,45,4977,0
filter_labels,2025-02-28T20:19:31.890729,b947c33b370d8a3251ef9c36ce7d71e8d16f4f8e,1798,40,1838,1792
answer_question,2025-02-28T20:19:33.296058,b947c33b370d8a3251ef9c36ce7d71e8d16f4f8e,1758,34,1792,0
filter_labels,2025-02-28T20:19:34.305229,6529fba868216a923407fb0d4e15a811a8e89ebc,1384,52,1436,1280
answer_question,2025-02-28T20:19:36.137594,6529fba868216a923407fb0d4e15a811a8e89ebc,989,35,1024,0
filter_labels,2025-02-28T20:19:37.168375,c06d5ad4b6408fec26675d30b37a6042c007095a,1106,51,1157,1024
answer_question,2025-02-28T20:19:40.241585,c06d5ad4b6408fec26675d30b37a6042c007095a,2008,69,2077,0
filter_labels,2025-02-28T20:19:41.821605,4e3efdc544140b872a59e124443a64c34f356911,798,78,876,0
answer_question,2025-02-28T20:19:46.611092,4e3efdc544140b872a59e124443a64c34f356911,2038,68,2106,0
filter_labels,2025-02-28T20:19:47.782086,aa781901e117281bfee6f8e4bea6fc9c9bada62e,2374,63,2437,2304
answer_question,2025-02-28T20:19:50.734884,aa781901e117281bfee6f8e4bea6fc9c9bada62e,5991,72,6063,0
filter_labels,2025-02-28T20:19:52.370673,105688726e097505beef4934896193ac51295037,1218,109,1327,1152
answer_question,2025-02-28T20:19:54.601972,105688726e097505beef4934896193ac51295037,4864,45,4909,0
filter_labels,2025-02-28T20:19:55.574759,1a12ef3f11a64e92eeca39e493a17d2860c014a6,3000,42,3042,2944
answer_question,2025-02-28T20:19:57.081673,1a12ef3f11a64e92eeca39e493a17d2860c014a6,1630,48,1678,0
filter_labels,2025-02-28T20:19:58.365047,aa781901e117281bfee6f8e4bea6fc9c9bada62e,2348,59,2407,2304
answer_question,2025-02-28T20:20:00.236753,aa781901e117281bfee6f8e4bea6fc9c9bada62e,2950,62,3012,0
filter_labels,2025-02-28T20:20:01.381252,d14ae2b6284e48b5c1e6659a0a5863d84697b3b9,1121,60,1181,1024
answer_question,2025-02-28T20:20:02.725014,d14ae2b6284e48b5c1e6659a0a5863d84697b3b9,1251,38,1289,0
answer_question,2025-02-28T20:20:31.136765,,899,108,1007,0
filter_labels,2025-02-28T20:20:32.504992,35839effbc332f23d5f34263aab3dcb2c6976420,1180,58,1238,1152
answer_question,2025-02-28T20:20:35.173533,35839effbc332f23d5f34263aab3dcb2c6976420,5422,35,5457,0
filter_labels,2025-02-28T20:20:36.575887,78c71282723c2d66216cbba13183d19349d302b8,3049,51,3100,2944
answer_question,2025-02-28T20:20:38.996764,78c71282723c2d66216cbba13183d19349d302b8,1934,89,2023,0
filter_labels,2025-02-28T20:20:40.390725,da663e46fbf02ec8a90b3f3c1079ef4c9f7907e1,5075,64,5139,4992
answer_question,2025-02-28T20:20:41.833396,da663e46fbf02ec8a90b3f3c1079ef4c9f7907e1,1610,38,1648,0
filter_labels,2025-02-28T20:20:43.256544,682de8e45fd9688f3452bc0e18257132a8f3cff6,1584,54,1638,1536
answer_question,2025-02-28T20:20:45.004613,682de8e45fd9688f3452bc0e18257132a8f3cff6,2609,45,2654,0
filter_labels,2025-02-28T20:20:47.096657,0279901b645e568591ad95dac2c2bf939ef0c00d,3322,100,3422,3200
answer_question,2025-02-28T20:20:51.660000,0279901b645e568591ad95dac2c2bf939ef0c00d,14178,66,14244,0
filter_labels,2025-02-28T20:20:53.452389,74c690176ce433301f4d1e808bb002a2f4dc321a,1277,105,1382,1152
answer_question,2025-02-28T20:20:55.487954,74c690176ce433301f4d1e808bb002a2f4dc321a,2621,45,2666,0
filter_labels,2025-02-28T20:20:56.883250,30f64d1043f4cb425eb636763580ae27094ffef1,2005,85,2090,1920
answer_question,2025-02-28T20:21:00.052725,30f64d1043f4cb425eb636763580ae27094ffef1,3764,53,3817,0
filter_labels,2025-02-28T20:21:01.415674,74c690176ce433301f4d1e808bb002a2f4dc321a,1273,69,1342,1152
answer_question,2025-02-28T20:21:03.279983,74c690176ce433301f4d1e808bb002a2f4dc321a,3963,38,4001,0
filter_labels,2025-02-28T20:21:05.129411,3f36d4f26ada778d89cf5a7344be0b9e9a5223a3,1396,124,1520,1280
answer_question,2025-02-28T20:21:09.582435,3f36d4f26ada778d89cf5a7344be0b9e9a5223a3,8167,88,8255,0
filter_labels,2025-02-28T20:21:10.777713,78c71282723c2d66216cbba13183d19349d302b8,3026,52,3078,2944
answer_question,2025-02-28T20:21:18.080634,78c71282723c2d66216cbba13183d19349d302b8,4706,66,4772,0
filter_labels,2025-02-28T20:21:22.791151,696ddc4c80febe0f1559ed3b1272487c74ca91cc,1365,121,1486,1280
answer_question,2025-02-28T20:21:25.124758,696ddc4c80febe0f1559ed3b1272487c74ca91cc,1962,37,1999,0
answer_question,2025-02-28T20:21:45.155375,,884,77,961,0
filter_labels,2025-02-28T20:21:47.590215,a69ebee82a9acd54117407ca3697db0d7bfbfdac,4986,94,5080,3072
answer_question,2025-02-28T20:21:50.401248,a69ebee82a9acd54117407ca3697db0d7bfbfdac,6640,48,6688,0
filter_labels,2025-02-28T20:21:51.757788,cc0fc5888b99758100a7ff024863fc4337b6b3c5,6017,73,6090,5888
answer_question,2025-02-28T20:21:55.272359,cc0fc5888b99758100a7ff024863fc4337b6b3c5,10072,45,10117,0
answer_question,2025-02-28T20:22:12.905668,,871,105,976,0
filter_labels,2025-02-28T20:22:14.233702,da663e46fbf02ec8a90b3f3c1079ef4c9f7907e1,5093,76,5169,4992
answer_question,2025-02-28T20:22:17.056130,da663e46fbf02ec8a90b3f3c1079ef4c9f7907e1,6170,84,6254,0
filter_labels,2025-02-28T20:22:18.734779,3bb894b4201667baf60b0b2c8a47109fa2357acb,882,99,981,0
answer_question,2025-02-28T20:22:19.932202,3bb894b4201667baf60b0b2c8a47109fa2357acb,1910,46,1956,0
filter_labels,2025-02-28T20:22:21.320372,da663e46fbf02ec8a90b3f3c1079ef4c9f7907e1,5097,63,5160,4992
answer_question,2025-02-28T20:22:22.520604,da663e46fbf02ec8a90b3f3c1079ef4c9f7907e1,596,49,645,0
answer_question,2025-02-28T20:22:44.559390,,889,83,972,0
filter_labels,2025-02-28T20:22:45.664488,67185fca2a09b3c46ee961b2c1ae160dab8b5231,1099,54,1153,1024
answer_question,2025-02-28T20:22:50.955150,67185fca2a09b3c46ee961b2c1ae160dab8b5231,948,80,1028,0
answer_question,2025-02-28T20:23:01.774656,,757,82,839,0
filter_labels,2025-02-28T20:23:02.824165,a69ebee82a9acd54117407ca3697db0d7bfbfdac,4985,54,5039,3072
answer_question,2025-02-28T20:23:05.241428,a69ebee82a9acd54117407ca3697db0d7bfbfdac,3125,47,3172,0
filter_labels,2025-02-28T20:23:07.015789,2db41ba86cc015db1f5f7de00b764a06e6de3dcc,2617,79,2696,2560
answer_question,2025-02-28T20:23:10.030982,2db41ba86cc015db1f5f7de00b764a06e6de3dcc,4686,44,4730,0
filter_labels,2025-02-28T20:23:11.204085,c8af22dbedd95ee719273792e5964ab8bbba17b2,2448,66,2514,2432
answer_question,2025-02-28T20:23:12.900463,c8af22dbedd95ee719273792e5964ab8bbba17b2,3265,69,3334,0
filter_labels,2025-02-28T20:23:15.487365,e229fc9f5c694e93b02ac312c231607a04e3e528,1863,123,1986,1792
answer_question,2025-02-28T20:23:17.581111,e229fc9f5c694e93b02ac312c231607a04e3e528,3935,67,4002,0
filter_labels,2025-02-28T20:23:18.910291,23b2c590c4887dfb86761730dd7156fe3b216ab7,3049,74,3123,2944
answer_question,2025-02-28T20:23:20.926319,23b2c590c4887dfb86761730dd7156fe3b216ab7,1671,54,1725,0
filter_labels,2025-02-28T20:23:23.089365,f879b3a802ccd6e8e6ca0a07ed8464318b7c0724,2353,113,2466,2304
answer_question,2025-02-28T20:23:24.547129,f879b3a802ccd6e8e6ca0a07ed8464318b7c0724,2908,32,2940,0
filter_labels,2025-02-28T20:23:25.649636,c06d5ad4b6408fec26675d30b37a6042c007095a,1111,55,1166,1024
answer_question,2025-02-28T20:23:27.213498,c06d5ad4b6408fec26675d30b37a6042c007095a,901,43,944,0
filter_labels,2025-02-28T20:23:28.347631,53a00624418f6c5c2d044344a4125bba7743614f,392,52,444,0
answer_question,2025-02-28T20:23:30.077919,53a00624418f6c5c2d044344a4125bba7743614f,617,72,689,0
filter_labels,2025-02-28T20:23:31.382504,3e5ccdb58faf901e75e31f154cb8330869ca5efa,952,73,1025,0
answer_question,2025-02-28T20:23:32.822322,3e5ccdb58faf901e75e31f154cb8330869ca5efa,3319,51,3370,0
filter_labels,2025-02-28T20:23:34.010684,553afbf09b6d83166b17acb02431c6cf38e4defc,845,65,910,0
answer_question,2025-02-28T20:23:35.959638,553afbf09b6d83166b17acb02431c6cf38e4defc,1632,53,1685,0
filter_labels,2025-02-28T20:23:37.187783,30f64d1043f4cb425eb636763580ae27094ffef1,1987,73,2060,1920
answer_question,2025-02-28T20:23:41.386939,30f64d1043f4cb425eb636763580ae27094ffef1,2309,78,2387,0
filter_labels,2025-02-28T20:23:42.566330,105688726e097505beef4934896193ac51295037,1216,65,1281,1152
answer_question,2025-02-28T20:23:44.493929,105688726e097505beef4934896193ac51295037,3423,43,3466,0
filter_labels,2025-02-28T20:23:45.937137,23b2c590c4887dfb86761730dd7156fe3b216ab7,3054,74,3128,2944
answer_question,2025-02-28T20:23:49.020418,23b2c590c4887dfb86761730dd7156fe3b216ab7,6803,58,6861,0
filter_labels,2025-02-28T20:23:50.203442,105688726e097505beef4934896193ac51295037,1218,63,1281,1152
answer_question,2025-02-28T20:23:51.981892,105688726e097505beef4934896193ac51295037,2480,45,2525,0
filter_labels,2025-02-28T20:23:53.413585,8f5e29eea4f4a3e944707c71148439ca1fd4b2d8,1175,60,1235,1152
answer_question,2025-02-28T20:23:56.213364,8f5e29eea4f4a3e944707c71148439ca1fd4b2d8,2552,71,2623,0
filter_labels,2025-02-28T20:23:57.476336,e7a45fed0d7ebfd13a524e7fcc443318bac654e2,3930,81,4011,3840
answer_question,2025-02-28T20:24:00.282768,e7a45fed0d7ebfd13a524e7fcc443318bac654e2,4368,68,4436,0
filter_labels,2025-02-28T20:24:01.865171,2db41ba86cc015db1f5f7de00b764a06e6de3dcc,2602,92,2694,2560
answer_question,2025-02-28T20:24:06.841002,2db41ba86cc015db1f5f7de00b764a06e6de3dcc,10742,65,10807,0
filter_labels,2025-02-28T20:24:08.202175,9e794a58e511f6a6a9a13b201d652deff9f9f69a,6304,73,6377,6272
answer_question,2025-02-28T20:24:12.516686,9e794a58e511f6a6a9a13b201d652deff9f9f69a,6475,52,6527,0
filter_labels,2025-02-28T20:24:13.696684,aa781901e117281bfee6f8e4bea6fc9c9bada62e,2367,64,2431,2304
answer_question,2025-02-28T20:24:25.535294,aa781901e117281bfee6f8e4bea6fc9c9bada62e,20259,79,20338,20224
filter_labels,2025-02-28T20:24:27.303960,a69ebee82a9acd54117407ca3697db0d7bfbfdac,4973,114,5087,3072
answer_question,2025-02-28T20:24:29.260093,a69ebee82a9acd54117407ca3697db0d7bfbfdac,1711,69,1780,0
answer_question,2025-02-28T20:24:45.280099,,868,108,976,0
filter_labels,2025-02-28T20:24:46.851658,12bff07b957b1c8f8cad9d917ca18005720cce9b,1452,106,1558,0
answer_question,2025-02-28T20:24:49.595929,12bff07b957b1c8f8cad9d917ca18005720cce9b,3156,77,3233,0
filter_labels,2025-02-28T20:24:50.625729,e273ed0d9626b9feaf50c09405c2b70d461e41d7,813,56,869,0
answer_question,2025-02-28T20:24:52.721309,e273ed0d9626b9feaf50c09405c2b70d461e41d7,2976,33,3009,0
filter_labels,2025-02-28T20:24:53.906930,682de8e45fd9688f3452bc0e18257132a8f3cff6,1586,57,1643,0
answer_question,2025-02-28T20:24:55.579073,682de8e45fd9688f3452bc0e18257132a8f3cff6,2798,47,2845,0
filter_labels,2025-02-28T20:24:56.572798,b947c33b370d8a3251ef9c36ce7d71e8d16f4f8e,1772,45,1817,0
answer_question,2025-02-28T20:24:58.015041,b947c33b370d8a3251ef9c36ce7d71e8d16f4f8e,1508,34,1542,0
filter_labels,2025-02-28T20:24:59.801977,5f226fe96206888930e3baaf0bff70d4b0a1db40,1330,63,1393,0
answer_question,2025-02-28T20:25:02.022017,5f226fe96206888930e3baaf0bff70d4b0a1db40,2593,48,2641,0
filter_labels,2025-02-28T20:25:03.546033,14fa568899745270c4ff2c10073f97f2c2e7764b,2754,84,2838,0
answer_question,2025-02-28T20:25:05.737475,14fa568899745270c4ff2c10073f97f2c2e7764b,2514,70,2584,0
filter_labels,2025-02-28T20:25:07.252622,12bff07b957b1c8f8cad9d917ca18005720cce9b,1439,82,1521,0
answer_question,2025-02-28T20:25:08.536710,12bff07b957b1c8f8cad9d917ca18005720cce9b,1029,31,1060,0
filter_labels,2025-02-28T20:25:10.381121,6529fba868216a923407fb0d4e15a811a8e89ebc,1381,73,1454,0
answer_question,2025-02-28T20:25:20.541924,6529fba868216a923407fb0d4e15a811a8e89ebc,6816,32,6848,0
filter_labels,2025-02-28T20:25:22.369364,99cd0edaf5bfb233e5f46ee55af837de0b725274,1558,80,1638,0
answer_question,2025-02-28T20:25:24.350515,99cd0edaf5bfb233e5f46ee55af837de0b725274,6517,42,6559,0
filter_labels,2025-02-28T20:25:26.342144,b947c33b370d8a3251ef9c36ce7d71e8d16f4f8e,1783,59,1842,0
answer_question,2025-02-28T20:25:28.452306,b947c33b370d8a3251ef9c36ce7d71e8d16f4f8e,3409,77,3486,0
filter_labels,2025-02-28T20:25:29.678985,0981826b4b43a88920f3e01c71ae73539bab84cc,1757,46,1803,0
answer_question,2025-02-28T20:25:30.951499,0981826b4b43a88920f3e01c71ae73539bab84cc,1360,35,1395,0
filter_labels,2025-02-28T20:25:32.343497,71d137454a1524843e1f49b34603438510232919,1826,67,1893,0
answer_question,2025-02-28T20:25:33.706681,71d137454a1524843e1f49b34603438510232919,1629,35,1664,0
filter_labels,2025-02-28T20:25:35.482203,c06d5ad4b6408fec26675d30b37a6042c007095a,1114,47,1161,0
answer_question,2025-02-28T20:25:37.147241,c06d5ad4b6408fec26675d30b37a6042c007095a,904,46,950,0
filter_labels,2025-02-28T20:25:38.260205,92d9de8e4db96e0b95a484afcd1c54c6beb62c03,1060,48,1108,0
answer_question,2025-02-28T20:25:39.597864,92d9de8e4db96e0b95a484afcd1c54c6beb62c03,2181,46,2227,0
filter_labels,2025-02-28T20:25:40.671993,3f36d4f26ada778d89cf5a7344be0b9e9a5223a3,1389,51,1440,0
answer_question,2025-02-28T20:25:43.316352,3f36d4f26ada778d89cf5a7344be0b9e9a5223a3,5573,34,5607,0
filter_labels,2025-02-28T20:25:45.604657,78c71282723c2d66216cbba13183d19349d302b8,3045,111,3156,0
answer_question,2025-02-28T20:25:50.243959,78c71282723c2d66216cbba13183d19349d302b8,7397,52,7449,0
